FIPS_Code,States,Area_Name,Civilian_labor_force_2020,Employed_2020,Unemployed_2020,Unemployment_rate_2020,Civilian_labor_force_2021,Employed_2021,Unemployed_2021,Unemployment_rate_2021,Civilian_labor_force_2022,Employed_2022,Unemployed_2022,Unemployment_rate_2022,POP_ESTIMATE_2020,POP_ESTIMATE_2021,POP_ESTIMATE_2022,BIRTHS_2020,BIRTHS_2021,BIRTHS_2022,DEATHS_2020,DEATHS_2021,DEATHS_2022,NoHSB,HSB,CAD,BD
1000,AL,Alabama,2269672,2124409,145263,6,2259349,2183330,76019,3,2286028,2226670,59358,2,5031362,5049846,5074296,13867,57112,58280,15165,69056,66870,430047,1041209,1032122,910425
1001,AL,"Autauga County, AL",26425,25023,1402,5,26545,25809,736,2,26789,26181,608,2,58902,59210,59759,162,694,709,177,682,673,4126,12977,11367,11144
1003,AL,"Baldwin County, AL",98979,92893,6086,6,99953,97034,2919,2,102849,100432,2417,2,233219,239361,246435,560,2367,2411,593,3044,2909,14555,44342,50518,52562
1005,AL,"Barbour County, AL",8684,8017,667,7,8280,7821,459,5,8241,7906,335,4,24960,24539,24706,60,276,277,93,383,372,4378,6600,5010,2007
1007,AL,"Bibb County, AL",8717,8085,632,7,8641,8347,294,3,8726,8507,219,2,22183,22370,22005,56,244,248,55,318,321,3125,7052,3967,1913
1009,AL,"Blount County, AL",25136,24010,1126,4,25377,24779,598,2,25796,25222,574,2,59102,59085,59512,137,656,674,201,865,844,6650,14284,13673,6061
1011,AL,"Bullock County, AL",4880,4589,291,6,4637,4455,182,3,4554,4426,128,2,10296,10280,10202,24,110,112,40,150,149,1540,2841,1692,804
1013,AL,"Butler County, AL",9238,8357,881,9,8819,8367,452,5,8804,8503,301,3,19031,18855,18650,47,219,222,88,331,317,1932,6050,3523,1879
1015,AL,"Calhoun County, AL",47047,43434,3613,7,46368,44497,1871,4,46140,44741,1399,3,116239,115677,115788,305,1276,1303,396,1868,1832,11867,27783,24939,15674
1017,AL,"Chambers County, AL",16102,14907,1195,7,15790,15220,570,3,15933,15523,410,2,34645,34446,34088,87,381,391,169,612,589,4275,8996,8167,3390
1019,AL,"Cherokee County, AL",11682,11090,592,5,11686,11390,296,2,11696,11422,274,2,24972,25026,25302,62,239,248,124,476,471,3720,6809,5543,2364
1021,AL,"Chilton County, AL",19951,18868,1083,5,20004,19443,561,2,20266,19806,460,2,45051,45259,45884,147,546,562,144,666,641,5569,13113,7719,4133
1023,AL,"Choctaw County, AL",4700,4357,343,7,4567,4370,197,4,4298,4133,165,3,12619,12549,12439,33,136,137,53,203,200,1802,3477,2915,1087
1025,AL,"Clarke County, AL",7898,7127,771,9,7736,7286,450,5,7694,7309,385,5,22981,22715,22515,57,282,285,101,436,423,2892,6740,4378,2259
1027,AL,"Clay County, AL",6146,5874,272,4,6048,5884,164,2,6130,5991,139,2,14211,14190,14198,33,153,156,39,257,244,1694,3813,3128,1334
1029,AL,"Cleburne County, AL",5857,5564,293,5,5913,5761,152,2,6141,5993,148,2,15063,15148,15346,37,168,172,48,259,251,1789,3958,3082,1730
1031,AL,"Coffee County, AL",22025,20970,1055,4,21624,21017,607,2,21597,21049,548,2,53547,54171,54805,159,678,685,176,722,704,4934,10108,12919,8202
1033,AL,"Colbert County, AL",23907,22186,1721,7,23609,22690,919,3,23842,23120,722,3,57299,57619,58033,166,636,647,176,880,858,5333,15244,12600,7213
1035,AL,"Conecuh County, AL",4583,4220,363,7,4390,4182,208,4,4242,4092,150,3,11553,11320,11206,29,123,122,45,234,228,1077,4200,2309,1079
1037,AL,"Coosa County, AL",4431,4163,268,6,4371,4238,133,3,4459,4346,113,2,10341,10366,10166,27,89,89,29,192,184,1217,3410,2623,915
1039,AL,"Covington County, AL",15352,14522,830,5,15233,14775,458,3,15152,14753,399,2,37507,37542,37602,88,425,431,158,709,702,3915,10037,8293,4176
1041,AL,"Crenshaw County, AL",6375,5980,395,6,6131,5929,202,3,5977,5820,157,2,13165,13056,13025,41,152,156,61,261,251,1742,3882,2133,1524
1043,AL,"Cullman County, AL",38896,37049,1847,4,38931,38020,911,2,39337,38525,812,2,88131,89618,90665,252,980,1005,254,1341,1273,9560,19624,21400,9979
1045,AL,"Dale County, AL",20944,19824,1120,5,20974,20315,659,3,21052,20500,552,2,49253,49412,49544,149,673,686,138,676,694,5093,10376,11859,6278
1047,AL,"Dallas County, AL",14834,13111,1723,11,13965,12977,988,7,13749,13055,694,5,38174,37565,36767,101,447,455,161,650,653,3709,10065,8304,4241
1049,AL,"DeKalb County, AL",31314,29766,1548,4,31002,30215,787,2,31146,30416,730,2,71648,71829,71998,188,801,819,222,1112,1081,10522,16172,14623,6969
1051,AL,"Elmore County, AL",37690,35711,1979,5,37873,36860,1013,2,38234,37395,839,2,87853,88737,89563,213,903,925,247,1097,1048,7459,19351,18732,14830
1053,AL,"Escambia County, AL",14612,13633,979,6,14142,13576,566,4,14231,13789,442,3,36680,36658,36666,93,427,440,134,640,636,4697,11249,6543,3227
1055,AL,"Etowah County, AL",41430,37969,3461,8,39439,37863,1576,4,39274,38085,1189,3,103447,103139,103088,289,1140,1162,365,1790,1763,10014,24491,24986,13067
1057,AL,"Fayette County, AL",6670,6304,366,5,6642,6439,203,3,6591,6411,180,2,16330,16155,16118,42,175,179,53,286,295,1951,4714,3472,1361
1059,AL,"Franklin County, AL",14579,13865,714,4,14352,13990,362,2,14565,14223,342,2,32075,31996,31932,97,397,407,109,495,480,4381,9016,4922,3050
1061,AL,"Geneva County, AL",11038,10537,501,4,11069,10762,307,2,11267,10997,270,2,26696,26667,26783,69,285,287,96,496,505,3294,6879,6103,2538
1063,AL,"Greene County, AL",3093,2732,361,11,2900,2711,189,6,2740,2620,120,4,7702,7592,7422,28,101,99,36,166,158,861,2173,1797,703
1065,AL,"Hale County, AL",6165,5537,628,10,5913,5589,324,5,5961,5729,232,3,14768,14737,14595,45,193,196,73,264,262,1890,3943,2664,1593
1067,AL,"Henry County, AL",6914,6545,369,5,6930,6711,219,3,7053,6862,191,2,17175,17434,17655,40,163,167,63,284,279,2280,3931,3358,2633
1069,AL,"Houston County, AL",47252,44465,2787,5,47193,45617,1576,3,48000,46756,1244,2,107286,107453,108079,312,1314,1338,311,1613,1530,9006,23633,24570,16350
1071,AL,"Jackson County, AL",23106,21760,1346,5,23072,22415,657,2,23185,22602,583,2,52545,52694,52891,127,528,542,201,989,952,6627,14431,10579,6072
1073,AL,"Jefferson County, AL",320567,298906,21661,6,320324,308963,11361,3,323290,314943,8347,2,674675,669997,665409,1919,7883,8052,2019,9111,8660,41479,121180,137209,159041
1075,AL,"Lamar County, AL",5791,5482,309,5,5708,5538,170,3,5724,5569,155,2,13956,13740,13705,29,156,159,51,250,239,1745,4151,3062,990
1077,AL,"Lauderdale County, AL",42678,40088,2590,6,42365,41045,1320,3,42919,41788,1131,2,94025,94862,95878,220,894,917,301,1383,1319,7275,22572,18101,16396
1079,AL,"Lawrence County, AL",14539,13757,782,5,14503,14085,418,2,14737,14382,355,2,33089,33123,33214,76,362,373,113,549,556,3912,9642,6211,3568
1081,AL,"Lee County, AL",76586,72200,4386,5,77205,75043,2162,2,79466,77595,1871,2,174742,177655,180773,460,1850,1886,325,1394,1372,9095,23254,32377,40727
1083,AL,"Limestone County, AL",45930,43793,2137,4,46983,45845,1138,2,48335,47322,1013,2,104190,107381,110900,289,1144,1168,215,1142,1123,9573,19395,21892,20159
1085,AL,"Lowndes County, AL",3722,3187,535,14,3586,3275,311,8,3506,3324,182,5,10273,9926,9777,32,124,126,62,188,181,1094,3094,1900,1083
1087,AL,"Macon County, AL",8186,7338,848,10,7937,7478,459,5,7862,7563,299,3,19473,18906,18516,29,183,182,78,292,290,2067,3765,4044,2663
1089,AL,"Madison County, AL",189778,180147,9631,5,193877,188817,5060,2,199231,194989,4242,2,390502,396593,403565,1076,4283,4365,838,4161,3931,21084,50364,74888,116323
1091,AL,"Marengo County, AL",7867,7330,537,6,7643,7323,320,4,7611,7351,260,3,19266,18961,18745,56,230,232,88,357,351,1750,4653,4071,2570
1093,AL,"Marion County, AL",13300,12564,736,5,13488,13111,377,2,13808,13464,344,2,29166,29006,29156,98,311,322,146,545,535,3921,7472,6963,2649
1095,AL,"Marshall County, AL",44822,42766,2056,4,44898,43831,1067,2,45464,44531,933,2,97696,98316,99423,340,1456,1493,315,1462,1413,10675,20178,20053,13852
1097,AL,"Mobile County, AL",195131,178433,16698,8,190714,181908,8806,4,192312,186073,6239,3,414353,413017,411411,1288,5138,5243,1339,5755,5477,34027,95988,83212,67053
1099,AL,"Monroe County, AL",7627,6954,673,8,7368,6963,405,5,7300,7001,299,4,19704,19557,19404,41,214,227,82,354,350,2440,6205,3435,1787
1101,AL,"Montgomery County, AL",108365,99200,9165,8,107330,102321,5009,4,107183,103886,3297,3,228322,226953,226361,782,3062,3121,713,2864,2782,18715,39384,43541,50876
1103,AL,"Morgan County, AL",59785,56858,2927,4,59785,58258,1527,2,60820,59548,1272,2,123288,123403,124211,343,1416,1445,382,1772,1684,12983,26406,26088,19291
1105,AL,"Perry County, AL",3452,3043,409,11,3206,2953,253,7,3083,2921,162,5,8458,8317,8035,30,98,98,31,176,173,1188,2229,1092,1051
1107,AL,"Pickens County, AL",7692,7139,553,7,7545,7242,303,4,7681,7431,250,3,18922,18615,18697,33,176,177,79,348,342,2332,5903,3851,1854
1109,AL,"Pike County, AL",15851,14999,852,5,16084,15575,509,3,16115,15674,441,2,32906,32740,33014,89,349,355,101,457,437,2465,7035,4515,5384
1111,AL,"Randolph County, AL",9578,9077,501,5,9490,9232,258,2,9692,9454,238,2,22092,22199,22479,63,254,259,84,368,359,3039,5304,4566,2500
1113,AL,"Russell County, AL",23836,22482,1354,5,23440,22726,714,3,23708,23091,617,2,59259,58668,58555,184,775,796,167,828,808,5881,11774,15342,6886
1115,AL,"St. Clair County, AL",41421,39209,2212,5,41602,40523,1079,2,42213,41285,928,2,91652,92903,93932,233,988,1004,265,1317,1275,8873,22302,20529,11730
1117,AL,"Shelby County, AL",117987,113068,4919,4,119405,116886,2519,2,121349,119126,2223,1,223881,227428,230115,537,2233,2284,446,1903,1881,9632,29933,43839,67668
1119,AL,"Sumter County, AL",4782,4417,365,7,4549,4349,200,4,4597,4435,162,3,12196,11961,11853,28,130,135,59,185,186,982,2588,2644,1502
1121,AL,"Talladega County, AL",36454,33656,2798,7,35915,34460,1455,4,36362,35239,1123,3,81428,80483,80704,219,888,902,264,1284,1309,9813,19830,18582,9138
1123,AL,"Tallapoosa County, AL",18214,16848,1366,7,17982,17271,711,4,17593,17091,502,2,41286,41132,40977,103,404,411,146,695,686,5432,9300,9406,5322
1125,AL,"Tuscaloosa County, AL",103837,96371,7466,7,101686,98093,3593,3,103432,100816,2616,2,231534,235668,236780,611,2479,2522,516,2321,2289,14563,41868,41083,43086
1127,AL,"Walker County, AL",25225,23619,1606,6,25324,24423,901,3,25568,24864,704,2,65132,64629,64339,165,729,747,309,1352,1282,8033,15674,15264,6391
1129,AL,"Washington County, AL",6823,6229,594,8,6547,6248,299,4,6565,6326,239,3,15327,15234,15122,48,184,188,52,220,224,1498,4606,3258,1469
1131,AL,"Wilcox County, AL",2918,2453,465,15,2631,2356,275,10,2528,2331,197,7,10432,10331,10059,28,123,122,50,174,177,1485,2806,2078,785
1133,AL,"Winston County, AL",10277,9748,529,5,10116,9838,278,2,10271,10020,251,2,23488,23672,23755,56,219,225,100,402,407,3520,6590,4616,2290
2000,AK,Alaska,347150,318298,28852,8,353158,330525,22633,6,356799,342400,14399,4,732923,734182,733583,2406,9461,9488,1163,5364,6396,32669,137873,165649,148191
2013,AK,"Aleutians East Borough, AK",2513,2409,104,4,2443,2382,61,2,2434,2386,48,2,3425,3424,3398,6,18,19,2,11,11,397,1080,707,414
2016,AK,"Aleutians West Census Area, AK",3835,3653,182,4,3516,3381,135,3,3480,3373,107,3,5222,5155,5122,12,34,34,4,23,20,344,1664,1185,645
2020,AK,"Anchorage Borough/municipality, AK",147314,135690,11624,7,149953,141113,8840,5,151342,146302,5040,3,290866,288702,287145,966,3766,3769,479,2188,2625,11299,45842,65086,71085
2050,AK,"Bethel Census Area, AK",6992,6132,860,12,6884,5984,900,13,6680,6091,589,8,18673,18599,18257,109,395,394,31,158,173,1808,4674,2267,1276
2060,AK,"Bristol Bay Borough, AK",394,363,31,7,446,421,25,5,422,404,18,4,829,841,865,2,6,6,2,6,8,34,194,273,142
2063,AK,"Chugach Census Area, AK",3256,2973,283,8,3179,3100,79,2,3387,3290,97,2,7077,6943,6874,17,68,72,6,44,54,225,1145,2029,1509
2066,AK,"Copper River Census Area, AK",1293,1154,139,10,1246,1205,41,3,1405,1275,130,9,2616,2611,2589,4,20,18,5,38,42,109,650,537,549
2068,AK,"Denali Borough, AK",648,535,113,17,811,726,85,10,997,934,63,6,1614,1594,1585,3,15,15,0,6,5,27,504,472,653
2070,AK,"Dillingham Census Area, AK",1722,1570,152,8,1688,1548,140,8,1665,1572,93,5,4835,4774,4723,19,79,80,8,47,56,388,1151,780,564
2090,AK,"Fairbanks North Star Borough, AK",44612,41615,2997,6,45067,42741,2326,5,45385,43716,1669,3,95328,95528,95356,336,1323,1331,113,537,673,3393,15698,22276,19976
2100,AK,"Haines Borough, AK",1025,857,168,16,1032,916,116,11,1058,988,70,6,2086,2074,2056,6,19,19,8,22,25,33,564,467,367
2105,AK,"Hoonah-Angoon Census Area, AK",1058,909,149,14,1152,1045,107,9,1251,1181,70,5,2362,2339,2287,5,23,25,7,25,26,119,694,664,425
2110,AK,"Juneau Borough/city, AK",16316,15169,1147,7,16801,15994,807,4,17387,16904,483,2,32202,31965,31685,70,269,276,49,209,250,1049,4791,7842,9145
2122,AK,"Kenai Peninsula Borough, AK",26661,24111,2550,9,27777,25747,2030,7,28188,26918,1270,4,58927,59851,60690,149,628,635,111,485,579,2497,12743,14742,11296
2130,AK,"Ketchikan Gateway Borough, AK",6487,5824,663,10,6567,6083,484,7,6786,6529,257,3,13918,13810,13741,42,135,134,30,105,124,591,2829,3795,2586
2150,AK,"Kodiak Island Borough, AK",6070,5664,406,6,5974,5580,394,6,5983,5723,260,4,13047,12864,12720,43,166,165,14,71,83,847,2508,2953,2599
2158,AK,"Kusilvak Census Area, AK",2291,1815,476,20,2364,1903,461,19,2254,1963,291,12,8373,8398,8278,63,247,251,17,69,74,833,2266,857,119
2164,AK,"Lake and Peninsula Borough, AK",613,543,70,11,654,597,57,8,638,601,37,5,1452,1419,1381,5,29,30,6,20,21,68,258,167,141
2170,AK,"Matanuska-Susitna Borough, AK",48442,44198,4244,8,49399,46004,3395,6,49942,47639,2303,4,107515,111059,113325,339,1331,1328,162,787,935,4384,23039,25821,16552
2180,AK,"Nome Census Area, AK",3943,3507,436,11,4038,3645,393,9,4138,3854,284,6,10028,9908,9835,48,202,202,25,90,95,695,2451,1443,1033
2185,AK,"North Slope Borough, AK",3164,2969,195,6,2906,2717,189,6,2969,2820,149,5,11002,11011,10805,34,139,140,8,58,62,865,2904,2145,1093
2188,AK,"Northwest Arctic Borough, AK",2943,2568,375,12,2867,2538,329,11,2787,2537,250,9,7790,7560,7423,38,155,152,14,64,74,673,2020,978,619
2195,AK,"Petersburg Borough, AK",1433,1302,131,9,1607,1494,113,7,1446,1362,84,5,3405,3373,3360,13,32,32,9,34,38,216,788,813,721
2198,AK,"Prince of Wales-Hyder Census Area, AK",2839,2560,279,9,2785,2557,228,8,2693,2545,148,5,5739,5734,5650,11,59,60,9,53,73,319,1588,1464,801
2220,AK,"Sitka Borough/city, AK",4123,3822,301,7,4457,4252,205,4,4529,4404,125,2,8425,8410,8382,17,90,89,7,56,76,316,1546,2202,2024
2230,AK,"Skagway Municipality, AK",643,504,139,21,641,554,87,13,745,695,50,6,1240,1142,1081,0,4,4,2,9,10,101,356,339,266
2240,AK,"Southeast Fairbanks Census Area, AK",2949,2720,229,7,3220,3006,214,6,3252,3083,169,5,6820,7005,7021,26,106,106,15,67,84,332,1704,1570,865
2275,AK,"Wrangell Borough/city, AK",956,868,88,9,942,871,71,7,886,841,45,5,2127,2100,2070,4,18,18,5,20,26,238,578,510,237
2282,AK,"Yakutat Borough/city, AK",279,255,24,8,311,289,22,7,312,296,16,5,684,709,700,1,11,11,0,3,2,21,173,154,40
2290,AK,"Yukon-Koyukuk Census Area, AK",2338,2041,297,12,2431,2132,299,12,2363,2177,186,7,5296,5280,5179,18,74,73,15,59,72,448,1471,1111,449
4000,AZ,Arizona,3471038,3199851,271187,7,3530579,3352198,178381,5,3615161,3477033,138128,3,7179943,7264877,7359197,18110,75384,78763,18030,80430,79329,560460,1125498,1610633,1495416
4001,AZ,"Apache County, AZ",19585,17105,2480,12,18917,17184,1733,9,18688,17253,1435,7,65911,65385,65432,233,746,780,315,1174,1188,7549,13150,16229,5434
4003,AZ,"Cochise County, AZ",50270,46788,3482,6,49009,46533,2476,5,48819,46666,2153,4,125522,125763,125663,319,1228,1285,363,1765,1784,9897,21308,33661,22569
4005,AZ,"Coconino County, AZ",72315,65369,6946,9,71853,67427,4426,6,74051,70842,3209,4,145180,142780,144060,335,1284,1335,286,1190,1193,7786,18341,26678,33393
4007,AZ,"Gila County, AZ",20432,18882,1550,7,20440,19384,1056,5,20410,19559,851,4,53351,53521,53922,110,454,476,213,1024,1028,5131,11192,15587,7382
4009,AZ,"Graham County, AZ",15470,14505,965,6,15730,15053,677,4,16113,15534,579,3,38638,38882,38779,107,482,504,77,453,459,3980,7123,9414,3529
4011,AZ,"Greenlee County, AZ",4324,4094,230,5,4364,4183,181,4,4766,4630,136,2,9526,9377,9302,32,118,123,19,93,88,710,1877,2253,922
4012,AZ,"La Paz County, AZ",8757,8139,618,7,8622,8161,461,5,8906,8487,419,4,16575,16391,16506,39,154,162,78,389,385,2110,4476,5038,1558
4013,AZ,"Maricopa County, AZ",2266227,2100505,165722,7,2320686,2213563,107123,4,2380680,2301171,79509,3,4440232,4494693,4551524,11597,48527,50726,9648,43593,42920,326737,644940,950635,1006096
4015,AZ,"Mohave County, AZ",86297,77769,8528,9,87413,82426,4987,5,89853,85787,4066,4,214176,216957,220816,400,1704,1792,1011,4421,4357,20437,55859,62716,23817
4017,AZ,"Navajo County, AZ",39345,35402,3943,10,39418,36799,2619,6,39644,37589,2055,5,106762,107621,108650,318,1233,1273,435,1816,1817,10766,20551,26746,11611
4019,AZ,"Pima County, AZ",481295,444630,36665,7,483156,458436,24720,5,489775,471177,18598,3,1045175,1048895,1057597,2351,9766,10192,2995,12899,12684,74468,149641,234802,240377
4021,AZ,"Pinal County, AZ",188734,174798,13936,7,193183,183710,9473,4,199232,191531,7701,3,429446,448144,464154,1069,4625,4837,1055,4745,4653,36411,89200,106188,61217
4023,AZ,"Santa Cruz County, AZ",18862,16722,2140,11,18914,17246,1668,8,18887,17464,1423,7,47705,48034,48759,148,536,557,95,448,450,6757,7913,8697,6994
4025,AZ,"Yavapai County, AZ",103874,96213,7661,7,105227,100681,4546,4,107575,103849,3726,3,237216,242193,246191,406,1666,1739,868,4053,4000,15280,45486,69858,50231
4027,AZ,"Yuma County, AZ",95256,78932,16324,17,93648,81412,12236,13,97765,85496,12269,12,204528,206241,207842,646,2861,2982,572,2367,2323,32441,34441,42131,20286
5000,AR,Arkansas,1346789,1263623,83166,6,1339665,1285329,54336,4,1369367,1323949,45418,3,3014195,3028122,3045637,8508,35115,36251,8493,40174,40187,248721,688732,592568,491269
5001,AR,"Arkansas County, AR",9312,8931,381,4,9351,9030,321,3,9344,9038,306,3,17107,16683,16512,52,193,195,72,322,326,1596,5020,3385,1987
5003,AR,"Ashley County, AR",7091,6415,676,9,6769,6275,494,7,6779,6406,373,5,18962,18649,18354,40,206,212,62,327,323,1988,6823,2988,1612
5005,AR,"Baxter County, AR",16365,15366,999,6,16239,15619,620,3,16572,15979,593,3,41687,42171,42435,77,333,346,197,903,903,3593,10992,11191,5892
5007,AR,"Benton County, AR",142227,135842,6385,4,144313,140227,4086,2,151719,148103,3616,2,286586,294337,302863,916,3667,3798,492,2479,2503,18811,53695,47163,63211
5009,AR,"Boone County, AR",15651,14808,843,5,15757,15277,480,3,15896,15438,458,2,37383,37890,38284,91,381,392,122,571,575,2849,8849,9820,4648
5011,AR,"Bradley County, AR",4311,4052,259,6,4072,3877,195,4,4093,3889,204,5,10488,10332,10135,28,111,112,44,181,182,1151,3111,2081,908
5013,AR,"Calhoun County, AR",2384,2257,127,5,2374,2293,81,3,2372,2298,74,3,4738,4737,4695,16,50,49,22,88,87,543,1490,984,421
5015,AR,"Carroll County, AR",12572,11845,727,5,12657,12219,438,3,12552,12182,370,2,28242,28480,28742,84,324,334,84,421,399,2948,7009,5585,4389
5017,AR,"Chicot County, AR",3175,2836,339,10,3039,2780,259,8,2987,2801,186,6,10157,10071,9873,28,102,102,37,170,174,1537,2725,1802,1050
5019,AR,"Clark County, AR",9145,8589,556,6,8768,8347,421,4,8532,8147,385,4,21387,21217,21250,60,234,239,68,313,307,1193,4037,3859,3516
5021,AR,"Clay County, AR",5476,5137,339,6,5389,5172,217,4,5446,5229,217,4,14528,14370,14265,40,165,169,47,276,282,1625,4430,2844,1448
5023,AR,"Cleburne County, AR",9080,8375,705,7,8948,8527,421,4,8986,8605,381,4,24696,25044,25284,48,211,216,90,449,450,2176,7850,5344,3144
5025,AR,"Cleveland County, AR",3215,3017,198,6,3106,2980,126,4,3093,2973,120,3,7550,7490,7467,16,77,73,28,132,130,514,2584,1509,924
5027,AR,"Columbia County, AR",8944,8319,625,7,8761,8288,473,5,8832,8447,385,4,22742,22510,22216,57,266,271,79,350,343,1824,5590,3805,2832
5029,AR,"Conway County, AR",8314,7801,513,6,8262,7913,349,4,8411,8096,315,3,20729,20911,21046,46,221,225,60,311,303,1706,5896,4093,2686
5031,AR,"Craighead County, AR",55924,52892,3032,5,56455,54602,1853,3,57622,56034,1588,2,111603,111788,113017,357,1498,1552,265,1210,1207,7292,23151,19662,20412
5033,AR,"Crawford County, AR",26322,24863,1459,5,25890,24948,942,3,26319,25473,846,3,60147,60423,61075,172,714,735,170,858,866,6161,13947,12959,7792
5035,AR,"Crittenden County, AR",20850,19069,1781,8,20399,19285,1114,5,20626,19791,835,4,48086,47475,47061,156,661,683,156,663,674,4784,10940,9749,5392
5037,AR,"Cross County, AR",7171,6724,447,6,6982,6673,309,4,6978,6721,257,3,16796,16693,16601,50,189,190,45,271,263,2138,4907,3051,1651
5039,AR,"Dallas County, AR",2784,2631,153,5,2760,2645,115,4,2737,2627,110,4,6442,6306,6191,15,66,63,27,129,128,571,2108,1445,536
5041,AR,"Desha County, AR",5223,4847,376,7,4928,4633,295,6,4969,4707,262,5,11320,11050,10771,27,115,116,39,187,190,1477,3415,1779,1057
5043,AR,"Drew County, AR",7619,7080,539,7,7475,7094,381,5,7445,7117,328,4,17314,17070,16911,64,213,217,66,270,269,1456,4090,2972,2652
5045,AR,"Faulkner County, AR",61390,57974,3416,5,61389,59233,2156,3,63157,61304,1853,2,123811,125645,127665,379,1457,1512,250,1187,1189,5268,23020,23023,25155
5047,AR,"Franklin County, AR",7395,6969,426,5,7273,6999,274,3,7450,7201,249,3,17135,17166,17271,47,183,189,63,274,277,1596,4911,4045,1251
5049,AR,"Fulton County, AR",4865,4609,256,5,4911,4728,183,3,5017,4847,170,3,12057,12156,12382,26,120,121,42,242,241,1224,3229,3236,989
5051,AR,"Garland County, AR",41218,37877,3341,8,41667,39624,2043,4,42272,40662,1610,3,100249,100386,100089,230,961,993,355,1691,1710,6955,23014,25131,17178
5053,AR,"Grant County, AR",8205,7771,434,5,8196,7929,267,3,8468,8206,262,3,18022,18149,18160,46,195,195,40,258,290,1055,5351,3893,2255
5055,AR,"Greene County, AR",19371,18191,1180,6,19309,18631,678,3,19800,19155,645,3,45864,46349,46448,151,523,540,115,599,603,3485,13628,8618,5004
5057,AR,"Hempstead County, AR",9503,8997,506,5,9117,8790,327,3,9356,9050,306,3,19981,19679,19453,54,255,265,62,281,274,2181,5182,3969,2159
5059,AR,"Hot Spring County, AR",13933,13108,825,5,13854,13311,543,3,13839,13353,486,3,33075,33108,33203,74,312,319,102,538,528,2699,9240,7783,3880
5061,AR,"Howard County, AR",5481,5199,282,5,5460,5278,182,3,5399,5219,180,3,12755,12676,12557,30,146,152,38,193,187,1028,3596,2753,1227
5063,AR,"Independence County, AR",16522,15549,973,5,16356,15712,644,3,16589,16032,557,3,37936,37742,37945,109,454,472,104,547,544,3610,9405,8201,4178
5065,AR,"Izard County, AR",4598,4201,397,8,4412,4171,241,5,4502,4269,233,5,13597,13928,14048,33,106,107,48,250,242,1838,3414,3270,1748
5067,AR,"Jackson County, AR",5778,5352,426,7,5571,5273,298,5,5513,5240,273,5,16755,16780,16624,41,155,159,56,293,288,1980,5169,3319,1519
5069,AR,"Jefferson County, AR",26998,24773,2225,8,26081,24379,1702,6,25654,24318,1336,5,66833,65649,64246,198,752,765,257,1027,1032,5383,19219,12779,9030
5071,AR,"Johnson County, AR",10011,9365,646,6,9798,9329,469,4,10101,9684,417,4,25722,25977,26001,76,308,314,72,329,341,3377,6929,3931,2716
5073,AR,"Lafayette County, AR",2389,2202,187,7,2314,2179,135,5,2319,2208,111,4,6299,6155,6101,14,66,66,25,129,131,864,2095,1117,490
5075,AR,"Lawrence County, AR",6722,6299,423,6,6709,6419,290,4,6841,6597,244,3,16212,16316,16205,38,188,192,62,280,276,1668,4271,3398,1631
5077,AR,"Lee County, AR",2713,2501,212,7,2547,2403,144,5,2568,2450,118,4,8528,8559,8364,23,87,85,37,177,177,1141,2847,1650,610
5079,AR,"Lincoln County, AR",3823,3591,232,6,3725,3552,173,4,3710,3544,166,4,12889,13151,12916,27,109,110,51,191,185,1855,4753,2401,862
5081,AR,"Little River County, AR",5285,4933,352,6,5187,4948,239,4,5205,5004,201,3,11975,11954,11821,29,145,146,47,222,227,847,3656,2629,1246
5083,AR,"Logan County, AR",8566,7983,583,6,8337,7981,356,4,8303,7986,317,3,21103,21207,21253,44,232,249,75,367,363,1853,6704,4635,1908
5085,AR,"Lonoke County, AR",33424,31534,1890,5,33331,32203,1128,3,34281,33310,971,2,74046,74766,75225,175,846,883,196,825,837,4955,18597,15689,10015
5087,AR,"Madison County, AR",7315,7022,293,4,7478,7243,235,3,7803,7609,194,2,16546,16936,17486,39,220,229,39,228,234,1734,5735,2467,1556
5089,AR,"Marion County, AR",6186,5778,408,6,6076,5812,264,4,6305,6070,235,3,16877,16970,17254,26,138,138,61,337,337,1770,4682,4416,1933
5091,AR,"Miller County, AR",19100,17751,1349,7,18760,17834,926,4,18764,18032,732,3,42579,42499,42552,132,518,539,141,627,637,3828,10586,9851,4950
5093,AR,"Mississippi County, AR",17062,15483,1579,9,16233,15080,1153,7,16376,15517,859,5,40544,39577,38896,139,543,564,136,651,652,4654,11058,7244,3813
5095,AR,"Monroe County, AR",2688,2505,183,6,2610,2469,141,5,2556,2443,113,4,6774,6660,6564,24,75,77,21,143,142,1030,2007,1169,655
5097,AR,"Montgomery County, AR",2925,2718,207,7,2885,2742,143,5,2865,2728,137,4,8488,8638,8556,23,87,87,30,173,173,1030,2111,2295,985
5099,AR,"Nevada County, AR",3500,3289,211,6,3350,3211,139,4,3443,3308,135,3,8285,8195,8181,16,77,74,31,127,128,517,2937,1633,637
5101,AR,"Newton County, AR",3145,2981,164,5,3178,3078,100,3,3204,3108,96,3,7193,7164,7078,15,57,58,33,141,143,790,2026,1652,877
5103,AR,"Ouachita County, AR",9714,9113,601,6,9647,9261,386,4,9656,9279,377,3,22614,22344,22049,70,257,266,85,410,400,1995,6501,5412,2131
5105,AR,"Perry County, AR",4090,3856,234,5,4115,3944,171,4,4229,4075,154,3,10000,9989,10063,23,92,90,37,148,148,617,3076,2156,1241
5107,AR,"Phillips County, AR",6226,5642,584,9,5829,5381,448,7,5609,5257,352,6,16443,15822,15304,40,208,214,75,320,318,2010,3489,3902,1575
5109,AR,"Pike County, AR",4215,3960,255,6,4199,4012,187,4,4081,3930,151,3,10172,10121,10179,27,116,119,31,165,168,865,2729,2160,1392
5111,AR,"Poinsett County, AR",9683,9132,551,5,9801,9418,383,3,9990,9652,338,3,22952,22730,22495,81,289,295,67,428,419,2920,7067,3972,1816
5113,AR,"Polk County, AR",7904,7364,540,6,7722,7372,350,4,7870,7582,288,3,19187,19331,19337,52,203,206,65,349,352,1569,5178,4748,2112
5115,AR,"Pope County, AR",27514,25850,1664,6,27139,26036,1103,4,27695,26624,1071,3,63403,63756,64065,173,700,726,183,789,779,6442,13836,11106,9502
5117,AR,"Prairie County, AR",3567,3372,195,5,3536,3404,132,3,3546,3441,105,3,8246,8094,8069,15,74,73,33,155,153,793,2552,1759,921
5119,AR,"Pulaski County, AR",187277,173081,14196,7,185928,176789,9139,4,189654,183049,6605,3,399246,398069,399145,1188,4947,5126,1078,4791,4737,23083,69538,79783,98432
5121,AR,"Randolph County, AR",7354,6908,446,6,7270,6977,293,4,7248,7002,246,3,18590,18842,18837,54,217,222,59,293,290,1821,4839,3945,2030
5123,AR,"St. Francis County, AR",7923,7284,639,8,7625,7153,472,6,7592,7221,371,4,23013,22701,22451,60,299,313,80,331,332,2950,6559,5273,1903
5125,AR,"Saline County, AR",58198,55203,2995,5,58254,56393,1861,3,60040,58385,1655,2,123815,125319,127357,332,1331,1383,290,1516,1509,6952,26015,28198,23685
5127,AR,"Scott County, AR",4291,4095,196,4,4173,4030,143,3,4230,4111,119,2,9828,9795,9805,33,117,121,32,177,177,1387,2827,1950,757
5129,AR,"Searcy County, AR",2840,2654,186,6,2889,2763,126,4,2875,2746,129,4,7842,7880,7918,25,74,75,25,157,138,1145,2282,1458,884
5131,AR,"Sebastian County, AR",55695,52300,3395,6,54536,52482,2054,3,55312,53598,1714,3,127800,128425,129059,373,1562,1618,338,1665,1698,13214,25325,26581,20559
5133,AR,"Sevier County, AR",5471,5145,326,6,5338,5097,241,4,5438,5227,211,3,15779,15709,15686,48,205,214,41,221,224,2662,3474,2752,1169
5135,AR,"Sharp County, AR",5645,5232,413,7,5634,5353,281,5,5842,5601,241,4,17319,17660,17810,45,180,185,64,350,334,2220,4873,4010,1391
5137,AR,"Stone County, AR",4566,4235,331,7,4514,4283,231,5,4590,4399,191,4,12350,12432,12575,25,122,125,62,237,245,1394,3128,3243,1304
5139,AR,"Union County, AR",15424,14109,1315,8,14934,14024,910,6,14840,14129,711,4,38926,38364,37752,99,443,464,150,644,641,3664,10177,8032,4931
5141,AR,"Van Buren County, AR",5699,5283,416,7,5816,5530,286,4,5960,5705,255,4,15801,15751,16102,36,138,142,64,298,296,1754,4857,3219,1910
5143,AR,"Washington County, AR",126006,120107,5899,4,127763,124018,3745,2,134071,130955,3116,2,246756,251692,256054,741,3054,3173,464,2053,2053,20070,40952,37453,50160
5145,AR,"White County, AR",33606,31453,2153,6,33654,32280,1374,4,34288,33086,1202,3,76851,77157,77755,200,860,890,226,1050,1087,7126,20258,12575,10174
5147,AR,"Woodruff County, AR",2790,2624,166,5,2751,2611,140,5,2806,2708,98,3,6228,6153,6049,13,69,69,25,119,121,785,1929,1037,720
5149,AR,"Yell County, AR",7829,7420,409,5,7796,7478,318,4,7941,7636,305,3,20214,20152,20129,57,246,253,58,300,296,3135,5240,3577,1953
6000,CA,California,18971560,17047569,1923991,10,18973377,17586314,1387063,7,19251974,18440895,811079,4,39501653,39142991,39029342,103123,412194,424652,74463,345550,318497,4236035,5477154,7632443,9451438
6001,CA,"Alameda County, CA",819689,746490,73199,8,812967,763473,49494,6,825606,798404,27202,3,1680380,1643837,1628997,4368,16805,17295,2746,12000,11040,131272,198825,271096,592670
6003,CA,"Alpine County, CA",515,455,60,11,513,471,42,8,501,474,27,5,1204,1235,1190,3,10,8,3,20,19,61,249,278,381
6005,CA,"Amador County, CA",14502,13142,1360,9,14399,13392,1007,7,14350,13716,634,4,40532,41144,41412,54,302,316,125,572,519,2757,9724,13052,6192
6007,CA,"Butte County, CA",93416,84666,8750,9,92217,85857,6360,6,91978,87878,4100,4,210135,206190,207303,488,1987,2049,513,2610,2439,13734,31704,54420,42309
6009,CA,"Calaveras County, CA",21395,19725,1670,7,21605,20356,1249,5,22266,21455,811,3,45346,46219,46563,88,369,378,128,619,574,3214,10815,13963,6959
6011,CA,"Colusa County, CA",10644,8894,1750,16,10669,9331,1338,12,10221,9035,1186,11,21858,21913,21914,64,284,294,39,187,175,3719,4246,3934,2043
6013,CA,"Contra Costa County, CA",547376,498091,49285,9,543996,509294,34702,6,551477,532060,19417,3,1165986,1163298,1156966,2940,11627,11956,2146,9671,8766,82564,140633,227162,354661
6015,CA,"Del Norte County, CA",9447,8535,912,9,9351,8641,710,7,9363,8884,479,5,27601,27553,27082,72,243,246,72,340,340,3825,6101,6601,3176
6017,CA,"El Dorado County, CA",91063,83355,7708,8,91879,86553,5326,5,93382,90231,3151,3,191220,193590,192646,395,1500,1533,411,1916,1782,7421,28993,51667,51363
6019,CA,"Fresno County, CA",446507,394472,52035,11,444507,403870,40637,9,453183,424273,28910,6,1009503,1012992,1015190,3319,13631,14075,1865,9545,8921,136835,140532,201826,140183
6021,CA,"Glenn County, CA",12784,11633,1151,9,12628,11741,887,7,12861,12175,686,5,28896,28664,28339,92,350,358,55,329,294,4303,5538,5728,2725
6023,CA,"Humboldt County, CA",59871,54757,5114,8,58907,55194,3713,6,59520,57147,2373,4,136261,134836,135010,299,1238,1284,329,1595,1486,8451,21654,34447,29263
6025,CA,"Imperial County, CA",71686,55464,16222,22,69015,56963,12052,17,70004,59736,10268,14,179595,179215,178713,536,2337,2354,435,1716,1664,32595,28187,32727,16758
6027,CA,"Inyo County, CA",8335,7670,665,8,8259,7767,492,6,8261,7955,306,3,19001,18927,18718,28,167,171,53,210,223,1088,4188,4721,3749
6029,CA,"Kern County, CA",387111,337439,49672,12,385852,347572,38280,9,391736,364575,27161,6,905828,912351,916108,2944,12175,12562,1720,8576,8009,132826,152266,169915,97236
6031,CA,"Kings County, CA",57116,50344,6772,11,55457,50082,5375,9,56448,52499,3949,7,152790,152679,152981,559,2152,2226,249,1247,1183,24856,24622,31283,13498
6033,CA,"Lake County, CA",28513,25729,2784,9,28445,26275,2170,7,28530,27116,1414,5,68195,68584,68191,168,677,700,183,975,907,6548,14601,19142,8557
6035,CA,"Lassen County, CA",9430,8734,696,7,9155,8598,557,6,8948,8549,399,4,32317,31813,29904,67,274,292,55,256,269,4853,7891,8716,2863
6037,CA,"Los Angeles County, CA",4960339,4350509,609830,12,4993482,4547611,445871,8,4984846,4739924,244922,4,9992236,9811842,9721138,23768,95117,98065,19906,86536,79777,1381447,1411475,1772567,2356572
6039,CA,"Madera County, CA",62067,55166,6901,11,62230,56756,5474,8,63447,59559,3888,6,156343,158910,160256,486,2043,2084,284,1470,1393,27789,22929,31711,16144
6041,CA,"Marin County, CA",130901,122013,8888,6,129479,123589,5890,4,131664,128169,3495,2,261282,259162,256018,507,2162,2230,525,2308,2102,12672,19589,44532,115907
6043,CA,"Mariposa County, CA",7217,6414,803,11,7052,6494,558,7,7291,6965,326,4,17118,17107,17020,36,141,140,45,237,216,1233,3028,5351,3901
6045,CA,"Mendocino County, CA",37232,33848,3384,9,36821,34503,2318,6,37183,35653,1530,4,91361,91003,89783,219,872,886,230,1133,1012,8704,17147,23338,15962
6047,CA,"Merced County, CA",115723,101215,14508,12,115207,103311,11896,10,115605,106730,8875,7,281814,284458,290014,906,3745,3853,524,2406,2236,49054,43880,49268,23259
6049,CA,"Modoc County, CA",3186,2906,280,8,3196,2966,230,7,3177,3003,174,5,8663,8571,8511,2,17,48,28,111,111,955,2136,2180,1293
6051,CA,"Mono County, CA",7899,6946,953,12,8304,7736,568,6,8669,8345,324,3,13226,13261,12978,44,112,117,7,52,52,1214,2124,3355,2804
6053,CA,"Monterey County, CA",214623,190693,23930,11,212225,194669,17556,8,220475,207384,13091,5,438390,437249,432858,1456,5417,5559,693,3262,3023,75771,56912,73530,74311
6055,CA,"Napa County, CA",69024,62851,6173,8,68555,64394,4161,6,71001,68724,2277,3,137485,136206,134300,299,1183,1217,324,1395,1270,14541,17698,29842,36464
6057,CA,"Nevada County, CA",46869,43061,3808,8,47368,44691,2677,5,48473,46809,1664,3,102249,103457,102293,205,781,800,275,1239,1146,3827,14963,29399,30391
6059,CA,"Orange County, CA",1566866,1426971,139895,8,1560697,1467342,93355,6,1590882,1540561,50321,3,3185516,3161005,3151184,7633,30238,31192,5287,25978,23822,294180,378888,598758,925364
6061,CA,"Placer County, CA",187363,173393,13970,7,189577,179955,9622,5,193823,187891,5932,3,405889,412789,417772,888,3582,3714,832,4008,3700,14584,49539,100475,117251
6063,CA,"Plumas County, CA",7643,6799,844,11,7481,6776,705,9,7428,6946,482,6,19749,19940,19351,32,148,155,64,216,238,820,4108,6655,3464
6065,CA,"Riverside County, CA",1121076,1008036,113040,10,1133045,1050042,83003,7,1152096,1104077,48019,4,2422847,2453178,2473902,6377,26775,27529,4820,23573,21844,267525,423504,511637,370132
6067,CA,"Sacramento County, CA",712190,644827,67363,9,719721,669851,49870,6,728310,699774,28536,3,1586465,1588106,1584169,4497,17846,18415,3071,14612,13318,127455,235075,363694,341705
6069,CA,"San Benito County, CA",32612,29382,3230,9,31831,29506,2325,7,32480,30856,1624,5,64521,66675,67579,170,766,806,103,478,442,6901,11037,14805,8460
6071,CA,"San Bernardino County, CA",974715,880887,93828,9,992229,918611,73618,7,1008492,967151,41341,4,2183239,2192882,2193656,6512,26192,26968,4011,20515,19025,260315,370115,445345,301891
6073,CA,"San Diego County, CA",1547325,1401923,145402,9,1547828,1447539,100289,6,1589551,1534802,54749,3,3296045,3274954,3276208,9171,36611,37683,5946,27327,24987,263063,409660,672143,906455
6075,CA,"San Francisco County/city, CA",560097,515631,44466,7,548615,520788,27827,5,572583,557983,14600,2,870393,811253,808437,2099,7577,7814,1590,6906,6340,77300,78359,123258,410052
6077,CA,"San Joaquin County, CA",335423,296890,38533,11,336882,307953,28929,8,344418,326351,18067,5,780558,788140,793229,2394,9541,9822,1504,7530,6952,96216,140468,156626,95083
6079,CA,"San Luis Obispo County, CA",134417,123926,10491,7,135428,128208,7220,5,137203,133048,4155,3,281879,279298,282013,608,2353,2426,605,2802,2544,15354,37215,67834,69920
6081,CA,"San Mateo County, CA",439455,409040,30415,6,433387,413318,20069,4,453379,442415,10964,2,762511,739060,729181,1890,7462,7662,1313,5474,4977,50652,82159,129495,289401
6083,CA,"Santa Barbara County, CA",218934,201111,17823,8,219871,207164,12707,5,223717,215888,7829,3,448244,437434,443837,1328,5307,5471,810,3862,3521,50274,47957,82013,97636
6085,CA,"Santa Clara County, CA",1025616,952499,73117,7,1012385,963744,48641,4,1040856,1013288,27568,2,1931026,1886595,1870945,4881,18995,19564,2755,12242,11180,145904,184860,284658,733950
6087,CA,"Santa Cruz County, CA",135102,121979,13123,9,133124,123902,9222,6,134175,127787,6388,4,270462,260495,264370,552,2181,2251,403,2088,1910,21102,28627,54858,75398
6089,CA,"Shasta County, CA",73403,66863,6540,8,72994,67951,5043,6,73134,69783,3351,4,181984,181981,180930,460,1801,1850,566,2769,2598,11492,33218,54858,29041
6091,CA,"Sierra County, CA",1289,1182,107,8,1308,1228,80,6,1320,1265,55,4,3228,3295,3217,6,23,25,8,36,37,130,681,981,515
6093,CA,"Siskiyou County, CA",17000,15297,1703,10,16704,15349,1355,8,16632,15682,950,5,43991,44026,43660,92,349,358,138,665,645,3250,8724,13316,6933
6095,CA,"Solano County, CA",202218,182483,19735,9,200674,185789,14885,7,202274,193768,8506,4,452698,450350,448747,1209,4875,5014,941,4232,3834,34837,74274,116367,86981
6097,CA,"Sonoma County, CA",246215,226415,19800,8,243679,230168,13511,5,248277,240509,7768,3,488281,484315,482650,1151,4343,4492,1072,4780,4427,38619,65278,120203,132345
6099,CA,"Stanislaus County, CA",242490,215869,26621,11,240200,220161,20039,8,242276,229135,13141,5,553217,552851,551275,1761,7048,7307,1054,5734,5368,69960,104577,111856,62589
6101,CA,"Sutter County, CA",45601,40420,5181,11,45375,41316,4059,8,46329,43293,3036,6,99464,99038,98503,295,1224,1256,227,1040,948,13202,15907,22792,12971
6103,CA,"Tehama County, CA",25724,23386,2338,9,25616,23772,1844,7,25735,24487,1248,4,65682,65380,65245,171,713,731,175,909,852,6389,13014,17864,7627
6105,CA,"Trinity County, CA",4550,4176,374,8,4556,4267,289,6,4572,4362,210,4,16089,16061,15781,18,103,108,35,186,180,764,4800,4605,2324
6107,CA,"Tulare County, CA",202865,175567,27298,13,201229,179892,21337,10,207469,190526,16943,8,473891,476946,477544,1600,6609,6796,915,4389,4083,76249,73748,86136,42332
6109,CA,"Tuolumne County, CA",20223,18078,2145,10,20102,18642,1460,7,19877,18990,887,4,55374,55065,54531,105,426,428,194,871,790,3344,10658,17887,10396
6111,CA,"Ventura County, CA",410872,374964,35908,8,407465,382236,25229,6,413641,398421,15220,3,843310,839358,832605,2023,8340,8569,1533,7386,6756,82625,113615,182934,195611
6113,CA,"Yolo County, CA",105028,96867,8161,7,106662,100331,6331,5,108984,104576,4408,4,216291,213039,222115,502,1923,1977,376,1601,1487,15832,22654,34203,54999
6115,CA,"Yuba County, CA",30773,27494,3279,10,30980,28369,2611,8,31596,29856,1740,5,81994,83216,84310,286,1125,1173,147,808,744,9568,11785,20436,9018
8000,CO,Colorado,3088995,2880227,208768,6,3158144,2986238,171906,5,3200625,3103531,97094,3,5784865,5811297,5839926,15589,62064,63086,11904,46644,49381,300620,810976,1139275,1686169
8001,CO,"Adams County, CO",270477,250200,20277,7,278583,261265,17318,6,282167,272672,9495,3,520479,523592,527575,1643,6673,6516,958,3858,4073,50604,94610,100759,88360
8003,CO,"Alamosa County, CO",8316,7824,492,5,8098,7616,482,6,8187,7890,297,3,16377,16563,16592,54,188,196,42,179,179,1281,2790,3227,2516
8005,CO,"Arapahoe County, CO",360185,333757,26428,7,370311,348866,21445,5,375538,363967,11571,3,655207,656557,655808,1902,7540,7585,1482,4886,5095,35396,87772,124579,198573
8007,CO,"Archuleta County, CO",7043,6549,494,7,6938,6573,365,5,6979,6759,220,3,13425,13798,14003,28,113,116,24,128,133,608,2228,3288,4071
8009,CO,"Baca County, CO",2086,2040,46,2,2038,1991,47,2,2062,2026,36,1,3482,3487,3432,5,38,38,20,80,78,368,735,837,605
8011,CO,"Bent County, CO",1790,1719,71,4,1773,1656,117,6,1774,1711,63,3,5478,5337,5399,7,38,35,21,79,84,586,2203,1103,645
8013,CO,"Boulder County, CO",190895,179951,10944,5,197814,189093,8721,4,201848,196759,5089,2,330922,327075,327468,622,2478,2533,570,2139,2264,9902,24354,47235,137939
8014,CO,"Broomfield County/city, CO",40436,37978,2458,6,41544,39652,1892,4,42504,41398,1106,2,74484,75375,76121,150,644,655,150,473,504,1738,6603,13147,29398
8015,CO,"Chaffee County, CO",9648,9078,570,5,9671,9245,426,4,9825,9559,266,2,19477,19711,20223,33,142,148,67,192,201,855,3939,4473,6025
8017,CO,"Cheyenne County, CO",1084,1060,24,2,1063,1037,26,2,1051,1031,20,1,1744,1716,1732,8,21,21,5,25,25,80,344,469,255
8019,CO,"Clear Creek County, CO",5966,5485,481,8,6074,5737,337,5,6163,5982,181,2,9393,9445,9355,15,63,51,19,66,68,201,1517,1801,4060
8021,CO,"Conejos County, CO",4006,3797,209,5,3914,3713,201,5,3971,3844,127,3,7458,7578,7579,29,101,102,30,118,121,525,1633,1604,1219
8023,CO,"Costilla County, CO",1813,1690,123,6,1798,1683,115,6,1785,1711,74,4,3501,3595,3603,6,29,30,11,48,49,342,762,865,634
8025,CO,"Crowley County, CO",1441,1367,74,5,1388,1310,78,5,1370,1318,52,3,5694,5731,5614,4,27,30,17,74,79,462,2166,1193,389
8027,CO,"Custer County, CO",2087,1990,97,4,2233,2137,96,4,2311,2243,68,2,4719,5064,5335,8,39,35,10,56,60,63,661,1532,1422
8029,CO,"Delta County, CO",14164,13298,866,6,13670,12892,778,5,13282,12802,480,3,31051,31383,31602,66,281,286,104,474,504,2376,8368,6938,5255
8031,CO,"Denver County/city, CO",420069,387997,32072,7,430927,405515,25412,5,436588,423094,13494,3,717556,711323,713252,2138,8540,9027,1600,5211,5599,51244,82175,110652,270034
8033,CO,"Dolores County, CO",1135,1063,72,6,1122,1066,56,5,1148,1114,34,3,2332,2370,2455,3,15,15,10,34,34,70,831,541,519
8035,CO,"Douglas County, CO",196251,185851,10400,5,202593,194188,8405,4,207841,202637,5204,2,360303,369825,375988,924,3629,3668,517,1936,2049,5012,28669,62473,139774
8037,CO,"Eagle County, CO",35394,32261,3133,8,34608,32944,1664,4,34793,33882,911,2,55665,55773,55285,126,519,531,40,178,181,3299,6210,10012,20252
8039,CO,"Elbert County, CO",15012,14366,646,4,15609,15004,605,3,16017,15629,388,2,26207,27133,27799,50,216,226,39,194,206,677,4341,6982,6546
8041,CO,"El Paso County, CO",342131,319056,23075,6,354358,334200,20158,5,358771,347092,11679,3,732342,737228,740567,2203,9191,9348,1331,5786,6330,26185,92459,166744,186376
8043,CO,"Fremont County, CO",15225,14131,1094,7,14916,13803,1113,7,14389,13711,678,4,48878,49234,49621,98,368,371,149,678,727,3916,15356,11607,7059
8045,CO,"Garfield County, CO",31416,29430,1986,6,30460,28914,1546,5,30903,29975,928,3,61792,62195,62271,180,718,733,85,396,433,4258,10536,12662,13481
8047,CO,"Gilpin County, CO",3932,3508,424,10,3908,3671,237,6,3935,3827,108,2,5824,5899,5891,17,44,41,9,41,36,293,664,1436,2283
8049,CO,"Grand County, CO",9247,8520,727,7,9160,8742,418,4,9298,9049,249,2,15748,15870,15769,39,120,124,13,89,100,659,3591,3144,4475
8051,CO,"Gunnison County, CO",11302,10606,696,6,11207,10759,448,4,11432,11150,282,2,16945,17309,17267,30,135,135,26,86,89,223,1826,2677,6196
8053,CO,"Hinsdale County, CO",423,407,16,3,423,407,16,3,438,427,11,2,788,773,775,0,3,3,2,6,5,27,120,249,348
8055,CO,"Huerfano County, CO",2596,2367,229,8,2549,2331,218,8,2470,2320,150,6,6827,6922,7082,16,45,46,28,148,150,404,1335,2079,1295
8057,CO,"Jackson County, CO",935,899,36,3,952,918,34,3,987,966,21,2,1378,1357,1302,3,6,6,3,16,18,150,253,382,294
8059,CO,"Jefferson County, CO",327752,306009,21743,6,337033,319955,17078,5,343275,333723,9552,2,583050,580926,576143,1460,5484,5590,1335,5259,5501,20549,82874,116802,202518
8061,CO,"Kiowa County, CO",954,933,21,2,926,894,32,3,898,882,16,1,1452,1446,1424,0,14,16,3,20,21,27,252,463,189
8063,CO,"Kit Carson County, CO",4215,4105,110,2,4074,3944,130,3,4116,4036,80,1,7066,6936,6961,20,88,89,26,96,98,517,1392,2007,871
8065,CO,"Lake County, CO",4806,4442,364,7,4668,4445,223,4,4835,4710,125,2,7404,7397,7327,15,73,73,8,47,51,629,1288,1519,1931
8067,CO,"La Plata County, CO",30937,28950,1987,6,30383,28702,1681,5,30851,29926,925,3,55675,56187,56607,119,436,444,101,429,449,1363,8171,11691,18796
8069,CO,"Larimer County, CO",201409,189568,11841,5,207700,197863,9837,4,210796,205073,5723,2,359899,362713,366778,790,3033,3062,645,2763,2844,8680,41169,69681,116607
8071,CO,"Las Animas County, CO",6401,5959,442,6,6194,5761,433,7,6074,5792,282,4,14482,14318,14327,30,116,121,56,206,224,1259,2830,4569,1997
8073,CO,"Lincoln County, CO",2342,2245,97,4,2242,2140,102,4,2204,2141,63,2,5665,5477,5510,10,46,46,17,62,67,474,2083,947,703
8075,CO,"Logan County, CO",10877,10404,473,4,10372,9880,492,4,10182,9900,282,2,21204,21122,20823,60,204,212,56,296,298,1302,5851,4954,3078
8077,CO,"Mesa County, CO",74746,69554,5192,6,77004,72514,4490,5,76866,74254,2612,3,156005,157434,158636,395,1508,1534,424,1891,2002,9126,29507,37707,31642
8079,CO,"Mineral County, CO",465,439,26,5,444,420,24,5,461,448,13,2,871,929,931,1,8,7,2,7,8,14,89,190,377
8081,CO,"Moffat County, CO",7163,6761,402,5,6895,6540,355,5,6833,6617,216,3,13264,13155,13177,31,141,140,33,158,164,717,3748,2791,1684
8083,CO,"Montezuma County, CO",12624,11782,842,6,12480,11731,749,6,12340,11876,464,3,25883,26216,26468,62,250,259,57,354,370,1693,5553,5743,5567
8085,CO,"Montrose County, CO",21494,20171,1323,6,21185,20035,1150,5,21234,20521,713,3,42817,43230,43811,95,388,397,120,545,588,3402,9615,9289,8027
8087,CO,"Morgan County, CO",15914,15118,796,5,15441,14629,812,5,15460,14961,499,3,29072,28995,29239,119,405,413,103,343,356,3600,5826,5973,3270
8089,CO,"Otero County, CO",8183,7715,468,5,7980,7457,523,6,7841,7515,326,4,18667,18536,18303,32,193,197,57,303,320,1539,4040,4678,2401
8091,CO,"Ouray County, CO",2481,2295,186,7,2562,2437,125,4,2521,2444,77,3,4881,5059,5100,10,33,30,9,29,33,55,542,1546,1843
8093,CO,"Park County, CO",10977,10389,588,5,11375,10899,476,4,11637,11337,300,2,17419,17758,17939,41,135,138,31,122,127,353,3502,5439,4596
8095,CO,"Phillips County, CO",2463,2401,62,2,2404,2330,74,3,2429,2378,51,2,4531,4508,4449,12,53,50,15,73,78,377,800,931,742
8097,CO,"Pitkin County, CO",11125,10036,1089,9,10526,9900,626,5,10598,10249,349,3,17354,17350,16876,38,129,130,16,69,72,335,1831,2897,8384
8099,CO,"Prowers County, CO",6120,5867,253,4,5998,5706,292,4,6117,5944,173,2,12010,11994,11854,50,149,154,33,171,184,1374,2255,2776,1301
8101,CO,"Pueblo County, CO",76173,70361,5812,7,77352,71183,6169,8,76448,73064,3384,4,168325,169332,169544,396,1686,1719,522,2349,2514,10891,33834,43094,27215
8103,CO,"Rio Blanco County, CO",2906,2759,147,5,2801,2635,166,5,2835,2729,106,3,6524,6453,6569,13,59,59,16,63,67,368,1420,1496,1029
8105,CO,"Rio Grande County, CO",5359,5002,357,6,5302,4936,366,6,5294,5070,224,4,11538,11388,11325,28,113,114,41,170,171,871,2331,2472,2306
8107,CO,"Routt County, CO",15929,14755,1174,7,15234,14537,697,4,15647,15251,396,2,24829,25056,25007,61,194,197,42,129,138,622,3035,5540,9498
8109,CO,"Saguache County, CO",3406,3182,224,6,3351,3143,208,6,3357,3242,115,3,6393,6505,6623,8,55,59,14,67,71,635,1460,1453,1212
8111,CO,"San Juan County, CO",519,487,32,6,567,545,22,3,570,555,15,2,710,740,803,1,4,5,2,6,6,19,166,136,234
8113,CO,"San Miguel County, CO",5424,4873,551,10,5411,5112,299,5,5581,5406,175,3,8054,8074,8003,13,52,52,8,29,30,107,1078,1316,3741
8115,CO,"Sedgwick County, CO",1155,1117,38,3,1136,1091,45,4,1066,1038,28,2,2390,2331,2295,6,14,14,16,41,45,197,460,700,392
8117,CO,"Summit County, CO",21969,19946,2023,9,21269,20347,922,4,21508,21026,482,2,30994,30971,30565,64,248,257,24,89,91,1320,4207,5888,12777
8119,CO,"Teller County, CO",12840,11946,894,7,13211,12551,660,5,13416,13015,401,3,24747,24939,24857,44,172,174,57,254,258,414,4782,6892,7089
8121,CO,"Washington County, CO",2848,2765,83,2,2721,2628,93,3,2756,2692,64,2,4808,4850,4812,7,47,49,16,82,80,290,1052,1290,747
8123,CO,"Weld County, CO",164952,154231,10721,6,166748,157126,9622,5,169213,163743,5470,3,331427,339811,350176,1126,4442,4505,589,2337,2465,24878,53024,69389,61569
8125,CO,"Yuma County, CO",5559,5414,145,2,5455,5294,161,3,5542,5430,112,2,9979,9943,9899,25,128,129,28,111,116,819,1858,2326,1538
9000,CT,Connecticut,1884099,1734478,149621,7,1855339,1739033,116306,6,1932463,1851993,80470,4,3597362,3623355,3626205,8465,33896,35818,11915,34649,34902,225021,656949,613201,1019966
10000,DE,Delaware,486497,449965,36532,7,493931,466770,27161,5,496688,474258,22430,4,992114,1004807,1018396,2579,10220,10744,2950,11230,11462,61788,209928,186528,232374
10001,DE,"Kent County, DE",79802,73176,6626,8,80940,75757,5183,6,80172,75965,4207,5,182362,184371,186946,522,2059,2171,517,2044,2089,13512,39620,36668,31039
10003,DE,"New Castle County, DE",299532,277339,22193,7,301965,285504,16461,5,304561,291284,13277,4,570873,572714,575494,1513,6024,6326,1551,5846,5958,29998,115392,100265,147694
10005,DE,"Sussex County, DE",107163,99450,7713,7,111025,105509,5516,5,111955,107009,4946,4,238879,247722,255956,544,2137,2247,882,3340,3415,18278,54916,49595,53641
11000,DC,District of Columbia,386296,355788,30508,7,378103,352468,25635,6,388403,370229,18174,4,670868,668791,671803,2187,8304,8096,2005,5832,5556,37934,75562,74761,299469
11001,DC,District of Columbia,386296,355788,30508,7,378103,352468,25635,6,388403,370229,18174,4,670868,668791,671803,2187,8304,8096,2005,5832,5556,37934,75562,74761,299469
12000,FL,Florida,10113733,9292632,821101,8,10353311,9872517,480794,4,10762307,10449041,313266,2,21589602,21828069,22244823,50292,207964,220578,56302,250785,260794,1682505,4282929,4543900,4839956
12001,FL,"Alachua County, FL",134721,127085,7636,5,138216,132947,5269,3,141466,137497,3969,2,279742,281817,284030,597,2503,2656,542,2356,2492,11583,34518,47001,76720
12003,FL,"Baker County, FL",11676,11058,618,5,12133,11672,461,3,12649,12301,348,2,28115,28673,27803,103,340,356,73,312,350,2687,8294,5088,2878
12005,FL,"Bay County, FL",82813,77619,5194,6,85781,82390,3391,4,87970,85609,2361,2,174506,179498,185134,424,1940,2070,472,2309,2464,12820,36401,46925,33073
12007,FL,"Bradford County, FL",10729,10053,676,6,10792,10333,459,4,11075,10728,347,3,28224,28050,27313,76,295,312,82,376,391,3665,8435,5843,2396
12009,FL,"Brevard County, FL",281902,262203,19699,7,289818,277874,11944,4,296542,288096,8446,2,608713,617742,630693,1162,4856,5165,1919,8907,9220,33648,118401,154084,141951
12011,FL,"Broward County, FL",1021788,926316,95472,9,1032694,981959,50735,4,1065006,1034531,30475,2,1943266,1935729,1947026,4890,19678,20879,4280,18332,19074,137900,368968,396510,471290
12013,FL,"Calhoun County, FL",4751,4494,257,5,4836,4612,224,4,4837,4679,158,3,13703,13514,13464,28,130,138,53,216,230,2267,4279,2587,1017
12015,FL,"Charlotte County, FL",71472,65990,5482,7,73472,70196,3276,4,76774,74142,2632,3,188013,194934,202661,255,1047,1108,776,3310,3398,12677,51705,51683,37650
12017,FL,"Citrus County, FL",46624,42495,4129,8,47660,44917,2743,5,49308,47269,2039,4,154565,158113,162529,256,1018,1079,761,3428,3537,12231,46072,39294,23478
12019,FL,"Clay County, FL",104766,98850,5916,5,108413,104509,3904,3,113134,110151,2983,2,218933,222533,226589,513,2104,2229,527,2484,2632,12043,42300,54742,39934
12021,FL,"Collier County, FL",176561,163700,12861,7,181287,174491,6796,3,189462,184206,5256,2,377293,387241,397994,743,3112,3295,958,4273,4429,30001,74930,72146,107989
12023,FL,"Columbia County, FL",29479,27632,1847,6,29371,28018,1353,4,29565,28615,950,3,69737,69902,71908,196,723,763,189,1062,1103,6451,17405,16494,7348
12027,FL,"DeSoto County, FL",14375,13596,779,5,13630,13053,577,4,13862,13408,454,3,34087,34340,35312,79,370,390,115,459,478,6215,10331,4964,3141
12029,FL,"Dixie County, FL",5854,5514,340,5,5841,5578,263,4,5852,5661,191,3,16690,16905,17124,21,166,172,58,277,292,2382,5967,2770,1353
12031,FL,"Duval County, FL",481031,446393,34638,7,493790,471485,22305,4,512417,496908,15509,3,997604,1002252,1016536,2968,12265,12995,2303,10862,11304,64073,189218,208644,212489
12033,FL,"Escambia County, FL",143826,133571,10255,7,145719,139015,6704,4,149075,144552,4523,3,322551,323480,324878,921,3686,3901,973,4395,4589,20274,58926,77404,59065
12035,FL,"Flagler County, FL",47144,43412,3732,7,48525,46234,2291,4,50464,48763,1701,3,116030,120904,126705,152,770,817,420,1739,1811,6736,28142,28962,23877
12037,FL,"Franklin County, FL",4659,4395,264,5,4714,4531,183,3,4825,4692,133,2,12463,12175,12498,15,95,95,30,176,192,2026,3071,2475,2026
12039,FL,"Gadsden County, FL",18231,16898,1333,7,18642,17594,1048,5,19143,18413,730,3,43402,43554,43403,109,480,505,151,607,635,5987,11085,7973,6106
12041,FL,"Gilchrist County, FL",7048,6684,364,5,7275,6997,278,3,7408,7184,224,3,17883,18306,18992,50,183,195,53,260,275,1692,5203,3916,1548
12043,FL,"Glades County, FL",5079,4772,307,6,4968,4751,217,4,5160,4994,166,3,12068,12268,12454,15,66,67,34,156,163,2962,3203,2222,1300
12045,FL,"Gulf County, FL",5082,4771,311,6,5273,5078,195,3,5432,5286,146,2,14264,14452,15314,32,117,121,50,235,246,1570,3889,3651,2729
12047,FL,"Hamilton County, FL",4213,3869,344,8,4203,3949,254,6,4203,4034,169,4,13733,13082,13217,42,161,167,42,207,216,2504,4752,2201,941
12049,FL,"Hardee County, FL",8478,7899,579,6,8892,8455,437,4,8783,8444,339,3,25331,25307,25645,81,334,350,58,286,327,3940,7693,3252,1698
12051,FL,"Hendry County, FL",15298,13955,1343,8,15346,14369,977,6,15497,14763,734,4,39725,40212,41339,121,507,539,94,423,455,7692,8913,6341,2125
12053,FL,"Hernando County, FL",72020,65956,6064,8,73851,70039,3812,5,76875,74123,2752,3,195627,200649,206896,383,1563,1653,743,3445,3583,15830,48346,51681,27894
12055,FL,"Highlands County, FL",34656,31832,2824,8,35239,33145,2094,5,36202,34693,1509,4,101345,103295,105618,183,785,826,438,2008,2089,10983,28122,24191,14640
12057,FL,"Hillsborough County, FL",754964,698029,56935,7,772739,739504,33235,4,804474,782198,22276,2,1466160,1484455,1513301,3982,16492,17500,3021,13601,14141,107589,262090,271547,353457
12059,FL,"Holmes County, FL",6826,6429,397,5,6925,6635,290,4,7035,6819,216,3,19569,19295,19651,41,193,208,71,330,352,2789,6541,3597,1364
12061,FL,"Indian River County, FL",64226,59231,4995,7,65660,62520,3140,4,67947,65644,2303,3,160439,163814,167352,278,1187,1259,590,2542,2669,10875,33926,38566,39249
12063,FL,"Jackson County, FL",17153,16163,990,5,17131,16330,801,4,16591,16053,538,3,47079,47154,48211,114,455,471,164,771,800,5848,14007,10635,4641
12065,FL,"Jefferson County, FL",5421,5102,319,5,5559,5318,241,4,5740,5556,184,3,14390,14476,15042,31,130,135,59,224,236,1745,3738,2972,2320
12067,FL,"Lafayette County, FL",2775,2649,126,4,2811,2698,113,4,2806,2719,87,3,8214,7958,7786,16,61,62,14,110,118,1577,2549,1415,437
12069,FL,"Lake County, FL",156918,142489,14429,9,159924,152354,7570,4,171050,165871,5179,3,386194,396242,410139,806,3304,3517,1178,5446,5693,26743,87063,93993,70206
12071,FL,"Lee County, FL",345536,318852,26684,7,359008,343793,15215,4,375434,363742,11692,3,765504,790676,822453,1644,6832,7262,2071,9136,9392,58139,175221,170001,164805
12073,FL,"Leon County, FL",150928,141624,9304,6,155338,148732,6606,4,159970,155227,4743,3,293948,296081,297369,727,2799,2949,540,2478,2625,11864,33154,47338,82078
12075,FL,"Levy County, FL",16503,15451,1052,6,16861,16089,772,4,17093,16498,595,3,43059,44158,45260,98,388,413,153,691,738,3877,13196,9383,4708
12077,FL,"Liberty County, FL",2596,2465,131,5,2604,2492,112,4,2630,2547,83,3,7805,7308,7603,21,69,69,19,101,106,1323,2383,1272,774
12079,FL,"Madison County, FL",7557,7067,490,6,7686,7299,387,5,7832,7575,257,3,17866,18069,18198,52,191,188,73,305,321,2629,4958,4112,1762
12081,FL,"Manatee County, FL",175925,163364,12561,7,180690,173348,7342,4,186606,181278,5328,2,401593,413474,429125,826,3411,3623,1219,5098,5271,28955,86428,86138,95733
12083,FL,"Marion County, FL",139119,128785,10334,7,143152,136025,7127,5,148279,143171,5108,3,377459,385084,396415,817,3405,3616,1345,6621,6912,32053,98785,85902,59174
12085,FL,"Martin County, FL",71469,66907,4562,6,73673,70987,2686,3,76101,74049,2052,2,158658,160249,162006,303,1223,1300,541,2380,2506,9692,31120,39899,42027
12086,FL,"Miami-Dade County, FL",1280601,1175315,105286,8,1323692,1250255,73437,5,1371121,1335035,36086,2,2695501,2670421,2673837,6613,27284,28949,6049,25467,26638,335701,506656,466138,608670
12087,FL,"Monroe County, FL",44503,40864,3639,8,46003,44616,1387,3,49262,48347,915,1,82852,82265,81708,170,671,712,193,797,848,5113,17890,18448,23001
12089,FL,"Nassau County, FL",41626,39170,2456,5,42888,41387,1501,3,44707,43568,1139,2,91027,94393,97899,200,805,857,245,1139,1200,5563,20197,18863,20796
12091,FL,"Okaloosa County, FL",95402,89907,5495,5,99698,96303,3395,3,103324,100805,2519,2,212071,213647,216482,640,2563,2705,471,2266,2394,10222,35339,50332,47693
12093,FL,"Okeechobee County, FL",17119,16145,974,5,17341,16601,740,4,17678,17136,542,3,39642,40044,40412,149,519,547,123,596,642,5457,10324,7696,4684
12095,FL,"Orange County, FL",742175,659050,83125,11,744702,706409,38293,5,792421,769611,22810,2,1431573,1427928,1452726,3770,15534,16466,2203,10284,10772,100495,231759,281212,340640
12097,FL,"Osceola County, FL",190129,163389,26740,14,186594,175021,11573,6,197366,190680,6686,3,391118,404020,422545,1077,4486,4772,659,3255,3444,33743,74371,82626,61263
12099,FL,"Palm Beach County, FL",716221,658815,57406,8,735244,703046,32198,4,763006,740847,22159,2,1494173,1503223,1518477,3324,13974,14835,4279,17648,18228,118849,254306,301015,412857
12101,FL,"Pasco County, FL",241029,222948,18081,7,247604,236516,11088,4,258149,250277,7872,3,566126,584927,608794,1169,4998,5314,1703,7780,7986,38259,133623,123782,104300
12103,FL,"Pinellas County, FL",477291,441651,35640,7,489255,469435,19820,4,510331,496830,13501,2,959465,959046,961739,1752,7239,7675,3191,13746,14143,58225,197083,233176,252931
12105,FL,"Polk County, FL",319951,289442,30509,9,328270,310484,17786,5,338322,326547,11775,3,730111,755179,787404,1854,8024,8532,1995,9288,9621,67511,167752,155642,103948
12107,FL,"Putnam County, FL",26419,24194,2225,8,27611,25941,1670,6,27491,26377,1114,4,73376,74059,74731,188,806,845,273,1339,1400,9495,21983,14196,6673
12109,FL,"St. Johns County, FL",137926,130460,7466,5,142837,138401,4436,3,149333,145849,3484,2,277085,293175,306841,504,2204,2336,553,2550,2629,10023,41159,50973,86951
12111,FL,"St. Lucie County, FL",147072,135130,11942,8,150839,143349,7490,5,155564,150258,5306,3,331428,344283,358704,719,3111,3313,937,4203,4393,27918,74500,77172,57367
12113,FL,"Santa Rosa County, FL",83014,78494,4520,5,84951,81930,3021,3,87512,85163,2349,2,188989,193783,198268,460,1897,2015,380,1990,2091,9992,35172,46571,37741
12115,FL,"Sarasota County, FL",184240,171009,13231,7,189591,182038,7553,4,195994,190365,5629,2,436207,448550,462286,672,2703,2871,1661,6999,7216,21710,91967,101780,128266
12117,FL,"Seminole County, FL",237886,219850,18036,7,245888,235755,10133,4,263804,256782,7022,2,471428,471009,478772,1136,4388,4645,922,4218,4399,19249,67983,104811,138702
12119,FL,"Sumter County, FL",32690,29978,2712,8,34967,33079,1888,5,37346,35829,1517,4,130298,134867,144970,105,480,506,568,2593,2677,8925,34680,33430,37682
12121,FL,"Suwannee County, FL",17665,16607,1058,6,17342,16546,796,4,17531,16963,568,3,43517,44092,45411,97,424,450,156,711,764,5264,12489,8125,4918
12123,FL,"Taylor County, FL",8163,7613,550,6,8091,7673,418,5,8085,7815,270,3,21739,20786,21283,47,203,217,76,338,343,2846,7091,4143,1908
12125,FL,"Union County, FL",4541,4314,227,5,4495,4322,173,3,4518,4386,132,2,15417,15825,15460,38,141,146,57,288,291,2670,4341,3469,1292
12127,FL,"Volusia County, FL",249000,229051,19949,8,256378,244365,12013,4,266061,257682,8379,3,555764,565988,579192,1100,4690,4980,1984,8934,9122,36146,126964,140873,103599
12129,FL,"Wakulla County, FL",15024,14321,703,4,15426,14925,501,3,15991,15589,402,2,33895,34274,35178,88,313,330,84,400,413,2849,8597,7838,4816
12131,FL,"Walton County, FL",32403,30426,1977,6,33883,32660,1223,3,35024,34130,894,2,75937,79988,83304,197,838,893,196,860,883,4753,15313,16497,17597
12133,FL,"Washington County, FL",9453,8873,580,6,9585,9147,438,4,9795,9482,313,3,25313,24877,25414,52,235,252,92,362,402,2990,7662,5278,2270
13000,GA,Georgia,5095696,4766734,328962,6,5179121,4977562,201559,3,5234275,5075093,159182,3,10729828,10788029,10912876,29842,121391,125538,24818,109531,109357,831989,1925348,1983294,2335225
13001,GA,"Appling County, GA",9226,8796,430,4,9309,8977,332,3,9346,9011,335,3,18366,18411,18428,39,210,212,73,278,277,2742,4741,3667,1199
13003,GA,"Atkinson County, GA",4469,4295,174,3,4434,4304,130,2,4374,4254,120,2,8311,8358,8183,30,117,126,22,113,118,1746,1739,1208,573
13005,GA,"Bacon County, GA",4863,4638,225,4,4830,4673,157,3,4879,4736,143,2,11108,11071,11191,33,157,152,47,171,175,1216,2873,2404,807
13007,GA,"Baker County, GA",1130,1063,67,5,1127,1072,55,4,1119,1074,45,4,2851,2827,2788,8,32,19,15,47,45,350,730,670,389
13009,GA,"Baldwin County, GA",17722,16508,1214,6,17631,16781,850,4,17754,17047,707,4,43794,43671,43635,98,400,397,148,603,612,3929,8989,7608,6946
13011,GA,"Banks County, GA",9857,9438,419,4,10311,10048,263,2,10897,10653,244,2,18082,18538,19328,50,215,224,45,248,260,2900,3997,3588,2070
13013,GA,"Barrow County, GA",40979,38919,2060,5,42196,40959,1237,2,43097,42011,1086,2,83975,86672,89299,241,1067,1139,184,837,831,6650,18643,17580,11296
13015,GA,"Bartow County, GA",50179,47086,3093,6,51348,49547,1801,3,52316,50813,1503,2,109296,110901,112816,309,1314,1356,319,1297,1283,9689,26564,21540,14253
13017,GA,"Ben Hill County, GA",5513,5137,376,6,5562,5268,294,5,5592,5350,242,4,17168,17152,17069,51,193,200,64,292,303,1880,5796,2642,1267
13019,GA,"Berrien County, GA",7449,7023,426,5,7641,7354,287,3,7772,7525,247,3,18148,18128,18214,54,203,207,60,290,290,2436,5107,3368,1635
13021,GA,"Bibb County, GA",67441,62427,5014,7,66983,63606,3377,5,65430,62987,2443,3,157025,155985,156197,495,1938,2079,479,2204,2237,13952,31471,30918,26173
13023,GA,"Bleckley County, GA",4523,4232,291,6,4606,4369,237,5,4546,4350,196,4,12524,12255,12257,32,122,127,47,195,198,1015,2843,3008,1304
13025,GA,"Brantley County, GA",7040,6666,374,5,7265,6997,268,3,7415,7159,256,3,18043,18121,18183,50,202,205,57,271,278,2331,5641,3677,809
13027,GA,"Brooks County, GA",6767,6412,355,5,6763,6508,255,3,6701,6493,208,3,16268,16285,16253,49,184,171,55,260,250,2090,3865,3474,1903
13029,GA,"Bryan County, GA",19164,18180,984,5,19844,19269,575,2,20150,19627,523,2,45035,46963,48225,141,584,615,81,371,364,2098,7363,8620,9110
13031,GA,"Bulloch County, GA",37295,34883,2412,6,38024,36461,1563,4,38398,37095,1303,3,79918,80637,83059,216,850,869,160,708,724,5273,13282,13499,12635
13033,GA,"Burke County, GA",9065,8419,646,7,9109,8578,531,5,9019,8551,468,5,24633,24333,24388,72,275,267,72,314,307,2491,5636,5018,2347
13035,GA,"Butts County, GA",10878,10216,662,6,11150,10747,403,3,11337,11023,314,2,25551,26114,26649,71,260,275,95,357,354,3318,7289,4851,2145
13037,GA,"Calhoun County, GA",2244,2129,115,5,2214,2124,90,4,2189,2119,70,3,5573,5534,5469,13,42,48,19,77,83,994,1619,1142,488
13039,GA,"Camden County, GA",21174,20166,1008,4,21522,20831,691,3,21930,21276,654,3,54925,55754,57013,169,706,725,99,487,494,2843,11216,13117,7580
13043,GA,"Candler County, GA",5750,5500,250,4,6009,5826,183,3,6089,5942,147,2,11022,11000,11000,27,143,146,36,206,222,1590,2784,1979,920
13045,GA,"Carroll County, GA",54871,51427,3444,6,56235,54166,2069,3,57286,55530,1756,3,119484,121592,124592,394,1499,1588,320,1390,1409,10824,25971,22157,16193
13047,GA,"Catoosa County, GA",32710,31286,1424,4,32865,31950,915,2,33352,32456,896,2,68006,68420,68826,169,694,705,185,943,891,5114,15510,15963,10398
13049,GA,"Charlton County, GA",4888,4702,186,3,4955,4797,158,3,5076,4918,158,3,12532,12813,12781,18,111,116,35,170,179,1742,3688,2554,1094
13051,GA,"Chatham County, GA",140138,129534,10604,7,143440,137279,6161,4,144226,139858,4368,3,295064,295656,301107,853,3473,3624,701,3145,3080,18800,48789,61535,71210
13053,GA,"Chattahoochee County, GA",1925,1804,121,6,1906,1820,86,4,1909,1822,87,4,9481,9044,8819,44,170,164,15,47,45,227,1158,2087,1137
13055,GA,"Chattooga County, GA",9786,8973,813,8,9478,9027,451,4,9240,8852,388,4,24922,24828,24936,57,248,253,87,394,401,4804,6255,4227,1861
13057,GA,"Cherokee County, GA",135499,129056,6443,4,139672,136005,3667,2,142815,139453,3362,2,268175,274839,281278,692,2812,2818,444,2167,2164,14341,40211,55201,68387
13059,GA,"Clarke County, GA",58181,54472,3709,6,58531,56275,2256,3,57891,55977,1914,3,128550,129185,129875,319,1283,1358,205,926,929,7515,14054,17175,34300
13061,GA,"Clay County, GA",903,793,110,12,879,792,87,9,831,775,56,6,2830,2859,2845,5,21,20,17,50,49,419,648,687,387
13063,GA,"Clayton County, GA",139123,124840,14283,10,140190,131371,8819,6,140266,134765,5501,3,297623,297318,296564,1004,3923,3808,570,2595,2509,26865,60708,58930,37141
13065,GA,"Clinch County, GA",2972,2856,116,3,3030,2940,90,3,3031,2947,84,2,6725,6698,6662,21,100,100,24,133,127,1181,1701,1199,502
13067,GA,"Cobb County, GA",413432,389213,24219,5,423814,410068,13746,3,431657,420518,11139,2,766374,766691,771952,2064,8476,8862,1356,5565,5500,36579,93670,132789,253049
13069,GA,"Coffee County, GA",19002,17905,1097,5,18754,17988,766,4,18792,18128,664,3,43052,42997,43172,126,544,559,137,570,568,6484,11127,6814,3988
13071,GA,"Colquitt County, GA",21933,20957,976,4,22172,21452,720,3,21979,21355,624,2,45900,45757,45762,148,597,616,142,666,652,7054,11510,7028,4311
13073,GA,"Columbia County, GA",75552,72414,3138,4,76129,74043,2086,2,75917,73779,2138,2,156849,159636,162419,448,1801,1795,293,1373,1334,7273,23328,33536,38541
13075,GA,"Cook County, GA",8126,7741,385,4,8167,7886,281,3,8223,7968,255,3,17234,17266,17404,48,200,205,62,241,238,2061,3536,3630,1843
13077,GA,"Coweta County, GA",74654,70107,4547,6,76347,73799,2548,3,77762,75691,2071,2,146725,149925,152882,380,1524,1585,310,1486,1489,9320,26095,29642,33025
13079,GA,"Crawford County, GA",5432,5156,276,5,5455,5249,206,3,5371,5203,168,3,12103,12139,12140,34,118,82,50,224,205,1611,3425,2591,976
13081,GA,"Crisp County, GA",9743,8870,873,9,10039,9180,859,8,9763,9351,412,4,20050,20024,19708,61,252,259,84,375,378,2290,5484,4114,1888
13083,GA,"Dade County, GA",7809,7487,322,4,7916,7704,212,2,8026,7816,210,2,16235,16230,16081,36,139,144,53,247,248,1912,3922,3473,1832
13085,GA,"Dawson County, GA",12707,12122,585,4,13137,12784,353,2,13427,13097,330,2,27056,28475,30138,64,283,299,64,293,304,2180,4392,6044,6147
13087,GA,"Decatur County, GA",11356,10814,542,4,11445,11028,417,3,11823,11440,383,3,29324,29045,28982,59,345,357,99,432,434,2995,6864,6574,2809
13089,GA,"DeKalb County, GA",394686,363515,31171,7,400986,382863,18123,4,405397,392693,12704,3,764420,759231,762820,2506,9905,10260,1435,5995,5871,48218,106060,125911,239583
13091,GA,"Dodge County, GA",6944,6529,415,6,6982,6683,299,4,6897,6639,258,3,19874,19675,19802,40,188,190,65,331,330,2045,5986,4223,2258
13093,GA,"Dooly County, GA",4989,4543,446,8,4930,4565,365,7,4772,4583,189,4,11165,10881,10572,21,97,99,57,187,189,1705,3657,2017,1160
13095,GA,"Dougherty County, GA",37597,34363,3234,8,37149,34815,2334,6,36369,34798,1571,4,85153,82267,82966,268,1087,1163,383,1234,1234,9186,16603,17437,12649
13097,GA,"Douglas County, GA",72637,67313,5324,7,74094,70903,3191,4,75159,72718,2441,3,144552,145628,147316,390,1648,1709,303,1321,1290,10876,27374,27434,27333
13099,GA,"Early County, GA",4432,4178,254,5,4341,4126,215,5,4425,4266,159,3,10799,10651,10574,33,117,117,63,194,197,1394,2727,1898,1009
13101,GA,"Echols County, GA",1888,1814,74,3,1882,1829,53,2,1873,1826,47,2,3720,3708,3686,14,48,46,5,46,44,535,1153,602,260
13103,GA,"Effingham County, GA",31979,30415,1564,4,33189,32208,981,3,33678,32818,860,2,65158,66746,69041,194,822,831,112,600,636,4005,15115,12378,10011
13105,GA,"Elbert County, GA",7957,7411,546,6,7813,7436,377,4,7872,7580,292,3,19667,19554,19814,47,198,205,75,363,351,2868,5511,3675,1731
13107,GA,"Emanuel County, GA",8595,7998,597,6,8670,8219,451,5,8717,8362,355,4,22887,22887,22929,65,278,282,73,377,386,2987,6501,3634,1924
13109,GA,"Evans County, GA",5023,4766,257,5,5129,4948,181,3,5050,4903,147,2,10790,10711,10695,46,127,130,21,161,162,1611,2694,1639,1115
13111,GA,"Fannin County, GA",11168,10643,525,4,11747,11410,337,2,11950,11632,318,2,25434,25763,25737,37,177,184,85,461,446,2422,6524,6044,4598
13113,GA,"Fayette County, GA",56779,53748,3031,5,58281,56582,1699,2,59593,58040,1553,2,119483,120681,122030,214,860,910,268,1144,1141,4149,16761,22426,37244
13115,GA,"Floyd County, GA",43265,40573,2692,6,43502,41884,1618,3,43798,42428,1370,3,98575,98499,99443,260,1084,1113,295,1414,1418,10691,21660,19511,13735
13117,GA,"Forsyth County, GA",123375,117844,5531,4,127280,124100,3180,2,130295,127263,3032,2,252878,260721,267237,556,2335,2339,340,1656,1619,10225,23420,37062,89689
13119,GA,"Franklin County, GA",9924,9345,579,5,9984,9611,373,3,9990,9674,316,3,23468,23503,24128,67,268,279,76,390,381,2878,5474,4813,2619
13121,GA,"Fulton County, GA",560504,516255,44249,7,569596,543672,25924,4,575874,557586,18288,3,1069370,1062531,1074634,2798,11198,12062,2026,8164,8193,48660,118809,150430,402523
13123,GA,"Gilmer County, GA",12059,11498,561,4,12325,11946,379,3,12413,12032,381,3,31428,32090,32407,80,287,291,92,473,484,3436,8108,6373,5041
13125,GA,"Glascock County, GA",1250,1200,50,4,1245,1212,33,2,1253,1215,38,3,2894,2906,2939,7,30,30,3,44,46,355,801,571,227
13127,GA,"Glynn County, GA",38419,35839,2580,6,39024,37551,1473,3,39697,38527,1170,2,84471,84705,85079,184,826,867,255,1152,1152,6561,16113,18707,18078
13129,GA,"Gordon County, GA",28186,26666,1520,5,28742,27815,927,3,28907,28088,819,2,57716,58253,58954,147,624,649,156,704,733,8990,13102,10321,6225
13131,GA,"Grady County, GA",10656,10193,463,4,11000,10652,348,3,10941,10613,328,3,26222,25879,26008,73,292,292,67,330,343,3564,6595,4741,2688
13133,GA,"Greene County, GA",7214,6797,417,5,7239,6968,271,3,7331,7098,233,3,19021,19553,20139,27,141,142,53,265,271,1699,4262,3400,4375
13135,GA,"Gwinnett County, GA",481779,451514,30265,6,492929,475852,17077,3,501409,487916,13493,2,958005,965145,975353,2647,10842,11064,1356,5917,5867,73577,135492,164197,233692
13137,GA,"Habersham County, GA",18782,17772,1010,5,18504,17842,662,3,18779,18201,578,3,46138,46740,47475,134,504,531,161,602,602,6014,10547,7129,7207
13139,GA,"Hall County, GA",102659,97868,4791,4,104554,101742,2812,2,107171,104611,2560,2,203735,207393,212692,613,2519,2598,477,2040,2015,25689,37544,36209,33257
13141,GA,"Hancock County, GA",2547,2324,223,8,2513,2355,158,6,2514,2390,124,4,8708,8664,8387,12,53,54,65,187,191,2109,2457,1616,627
13143,GA,"Haralson County, GA",12409,11690,719,5,12772,12324,448,3,13028,12634,394,3,30037,30579,31337,83,351,363,102,474,466,3462,7942,5593,3452
13145,GA,"Harris County, GA",16900,16140,760,4,16830,16343,487,2,16814,16355,459,2,34896,35605,36276,69,307,313,97,360,362,1610,6147,8505,7787
13147,GA,"Hart County, GA",11365,10754,611,5,11631,11178,453,3,12111,11745,366,3,25871,26340,26909,63,264,260,84,391,400,3364,6753,5579,3130
13149,GA,"Heard County, GA",5123,4793,330,6,5247,5044,203,3,5330,5171,159,3,11448,11529,11725,34,129,128,44,173,176,1408,3304,2309,820
13151,GA,"Henry County, GA",116778,108320,8458,7,118859,113922,4937,4,120701,116898,3803,3,241848,245023,248364,574,2481,2678,474,2087,2156,11711,48272,50451,43452
13153,GA,"Houston County, GA",70712,67032,3680,5,71257,68638,2619,3,70748,68554,2194,3,164343,167156,169631,465,1943,1986,358,1680,1673,7389,29772,35545,33011
13155,GA,"Irwin County, GA",3495,3300,195,5,3555,3394,161,4,3537,3397,140,4,9650,9375,9126,30,103,99,37,157,152,1414,2308,1823,1144
13157,GA,"Jackson County, GA",40192,38450,1742,4,42144,41118,1026,2,46153,45209,944,2,76717,80317,83936,206,923,963,192,824,813,6875,16087,14580,12516
13159,GA,"Jasper County, GA",6839,6508,331,4,7076,6849,227,3,7207,7019,188,2,14666,15259,15951,29,147,147,32,210,204,1247,4400,2794,1622
13161,GA,"Jeff Davis County, GA",6153,5839,314,5,6107,5864,243,4,6148,5926,222,3,14799,14848,14889,45,174,178,48,232,225,1966,3391,3019,1235
13163,GA,"Jefferson County, GA",6695,6248,447,6,6669,6345,324,4,6627,6363,264,4,15678,15494,15314,29,163,165,62,294,290,2180,4441,2933,1194
13165,GA,"Jenkins County, GA",3198,2997,201,6,3192,3040,152,4,3324,3183,141,4,8666,8776,8689,16,91,92,34,123,133,1108,2760,1865,501
13167,GA,"Johnson County, GA",4014,3817,197,4,4128,3981,147,3,4004,3888,116,2,9186,9034,9242,22,97,96,27,154,153,1666,3011,1441,611
13169,GA,"Jones County, GA",13408,12803,605,4,13473,13050,423,3,13320,12930,390,2,28397,28409,28472,66,279,246,77,415,404,1713,8012,6288,3449
13171,GA,"Lamar County, GA",8010,7508,502,6,8263,7918,345,4,8391,8116,275,3,18551,18684,19467,46,211,216,65,283,292,1254,4416,4275,2211
13173,GA,"Lanier County, GA",3814,3615,199,5,3817,3668,149,3,3783,3653,130,3,9926,10052,10171,29,144,141,22,111,114,976,2875,1656,1152
13175,GA,"Laurens County, GA",19343,18060,1283,6,19714,18868,846,4,19146,18411,735,3,49544,49527,49660,139,565,590,179,750,786,4494,13762,9239,5501
13177,GA,"Lee County, GA",15074,14390,684,4,15053,14584,469,3,15011,14577,434,2,33215,33194,33642,92,324,316,86,334,330,1887,5845,7045,6560
13179,GA,"Liberty County, GA",25790,24190,1600,6,26234,25191,1043,4,26158,25301,857,3,65317,66844,68030,336,1326,1387,101,544,553,3208,11447,15411,7371
13181,GA,"Lincoln County, GA",3519,3331,188,5,3540,3398,142,4,3511,3389,122,3,7701,7750,7841,13,76,75,24,125,125,935,2480,1504,757
13183,GA,"Long County, GA",8211,7854,357,4,8432,8173,259,3,8473,8210,263,3,16269,17089,18348,60,271,264,34,148,147,1840,3730,3379,1537
13185,GA,"Lowndes County, GA",51656,48546,3110,6,51231,49132,2099,4,50565,48914,1651,3,118415,118914,119739,364,1568,1632,239,1190,1188,7698,22621,20773,18362
13187,GA,"Lumpkin County, GA",16612,15822,790,4,17595,17112,483,2,18582,18131,451,2,33631,32890,34796,74,301,308,61,384,397,2438,5571,6131,6797
13189,GA,"McDuffie County, GA",8577,7903,674,7,8508,8065,443,5,8409,8037,372,4,21603,21636,21713,74,259,267,70,314,307,2328,5891,4080,2338
13191,GA,"McIntosh County, GA",5964,5629,335,5,6101,5876,225,3,6215,6022,193,3,10987,11051,11180,20,92,88,35,209,210,1476,3232,2599,1612
13193,GA,"Macon County, GA",4667,4314,353,7,4682,4378,304,6,4533,4344,189,4,12021,11832,11765,34,125,123,58,185,177,2432,3220,2314,894
13195,GA,"Madison County, GA",13260,12594,666,5,13456,13038,418,3,13357,12972,385,2,30269,30883,31473,85,374,385,74,384,377,3743,6784,5876,4192
13197,GA,"Marion County, GA",3249,3085,164,5,3248,3129,119,3,3246,3131,115,3,7530,7426,7449,14,74,69,20,131,126,1257,2000,1418,780
13199,GA,"Meriwether County, GA",8768,8017,751,8,8900,8442,458,5,8991,8649,342,3,20606,20715,20845,64,246,241,89,397,383,3004,5921,3945,1729
13201,GA,"Miller County, GA",2779,2669,110,4,2803,2719,84,3,2874,2798,76,2,5988,5886,5807,19,56,57,24,108,108,616,1194,1500,816
13205,GA,"Mitchell County, GA",8313,7771,542,6,8211,7797,414,5,8240,7913,327,4,21668,21266,21116,50,242,241,98,332,334,2637,5468,5216,1767
13207,GA,"Monroe County, GA",12940,12294,646,5,12959,12549,410,3,12795,12435,360,2,28055,28729,29427,69,264,259,97,407,386,2185,6797,4795,5577
13209,GA,"Montgomery County, GA",3843,3637,206,5,3824,3665,159,4,3860,3712,148,3,8574,8654,8655,22,102,107,26,128,133,1100,2161,1479,1024
13211,GA,"Morgan County, GA",9251,8760,491,5,9532,9223,309,3,9703,9442,261,2,20198,20654,21031,54,204,212,49,276,279,1459,5055,3609,3775
13213,GA,"Murray County, GA",15429,14277,1152,7,15380,14714,666,4,15366,14755,611,4,40012,40032,40472,117,438,431,105,523,533,7259,9146,7530,2730
13215,GA,"Muscogee County, GA",77456,71454,6002,7,76318,72313,4005,5,75466,72359,3107,4,206998,205024,202616,665,2686,2805,564,2499,2482,15462,35732,45434,36851
13217,GA,"Newton County, GA",52287,48607,3680,7,53489,51158,2331,4,54323,52466,1857,3,112843,115318,117621,321,1252,1297,269,1231,1228,7859,23970,24302,15514
13219,GA,"Oconee County, GA",19673,18955,718,3,20071,19621,450,2,19984,19523,461,2,42013,43025,43588,82,341,341,82,355,357,1060,5027,6811,13738
13221,GA,"Oglethorpe County, GA",6867,6543,324,4,6953,6751,202,2,6909,6720,189,2,14867,15142,15469,40,148,145,51,218,202,1572,3849,2772,2213
13223,GA,"Paulding County, GA",87086,82512,4574,5,89524,86832,2692,3,91455,89068,2387,2,169570,173921,178421,475,1988,1927,316,1386,1345,10048,32437,38031,28122
13225,GA,"Peach County, GA",11873,11139,734,6,11995,11416,579,4,11858,11408,450,3,28040,28245,28562,76,291,349,88,364,377,2686,5674,5681,3900
13227,GA,"Pickens County, GA",15079,14366,713,4,15564,15127,437,2,15924,15515,409,2,33339,33990,34826,75,289,290,107,468,453,2855,8004,7315,5889
13229,GA,"Pierce County, GA",8541,8156,385,4,8638,8368,270,3,8901,8657,244,2,19746,19975,20168,57,230,238,54,318,327,1827,5561,3743,2034
13231,GA,"Pike County, GA",8725,8298,427,4,8997,8742,255,2,9208,8960,248,2,18936,19534,19990,47,195,203,43,232,245,1529,4629,4039,2607
13233,GA,"Polk County, GA",18340,17256,1084,5,18448,17789,659,3,18531,17960,571,3,42923,43332,43709,126,531,572,120,614,643,5113,11679,7797,3738
13235,GA,"Pulaski County, GA",3965,3779,186,4,4027,3874,153,3,4006,3873,133,3,9873,9582,9984,30,97,102,33,149,163,1454,2694,2337,930
13237,GA,"Putnam County, GA",8315,7781,534,6,8658,8310,348,4,8764,8460,304,3,22163,22643,22984,52,213,215,66,328,347,1959,5631,4152,4106
13239,GA,"Quitman County, GA",798,748,50,6,765,729,36,4,733,697,36,4,2228,2236,2249,6,24,21,15,46,48,545,621,428,159
13241,GA,"Rabun County, GA",7258,6876,382,5,7552,7314,238,3,7774,7548,226,2,16914,17088,17206,35,155,159,69,320,299,1825,3870,3700,3320
13243,GA,"Randolph County, GA",2474,2328,146,5,2369,2245,124,5,2392,2287,105,4,6368,6253,6116,18,67,69,51,127,125,898,1587,1268,530
13245,GA,"Richmond County, GA",84317,77914,6403,7,83932,79496,4436,5,82682,79202,3480,4,206526,205358,206640,691,2625,2810,553,2602,2617,18444,43200,43097,30569
13247,GA,"Rockdale County, GA",43751,40454,3297,7,44637,42608,2029,4,45269,43698,1571,3,93644,93961,94984,235,931,969,216,941,971,6555,17913,20130,17274
13249,GA,"Schley County, GA",2153,2061,92,4,2132,2051,81,3,2161,2081,80,3,4534,4476,4496,14,55,56,11,55,55,411,1079,1078,464
13251,GA,"Screven County, GA",5063,4653,410,8,5097,4813,284,5,5033,4815,218,4,14078,14055,13977,34,166,163,47,232,236,1658,3796,3067,1464
13253,GA,"Seminole County, GA",3105,2951,154,5,3084,2969,115,3,3090,2981,109,3,9131,9142,9127,16,94,96,37,161,161,955,2689,2045,1069
13255,GA,"Spalding County, GA",28428,26291,2137,7,29015,27678,1337,4,29358,28383,975,3,67455,67699,68919,213,821,844,230,1075,1063,7425,17932,11936,8520
13257,GA,"Stephens County, GA",10463,9800,663,6,10435,9983,452,4,10640,10262,378,3,26820,26765,26767,74,285,302,87,464,445,2924,7312,4952,2961
13259,GA,"Stewart County, GA",2520,2380,140,5,2555,2458,97,3,2597,2504,93,3,5304,4914,4648,10,31,33,17,76,73,1246,1498,892,664
13261,GA,"Sumter County, GA",12625,11690,935,7,12306,11608,698,5,12280,11778,502,4,29516,28978,28877,86,335,348,116,425,425,3126,6903,5090,3644
13263,GA,"Talbot County, GA",2765,2578,187,6,2784,2659,125,4,2811,2708,103,3,5726,5746,5747,11,48,46,21,106,103,795,1835,1147,620
13265,GA,"Taliaferro County, GA",534,496,38,7,536,509,27,5,541,518,23,4,1562,1560,1600,2,13,15,9,32,35,228,585,371,111
13267,GA,"Tattnall County, GA",9702,9289,413,4,9545,9236,309,3,9388,9103,285,3,24316,24132,24064,72,253,268,57,307,319,3565,6287,3969,2338
13269,GA,"Taylor County, GA",2776,2577,199,7,2901,2726,175,6,2626,2496,130,5,7819,7754,7737,22,78,76,28,135,136,1332,2121,1287,868
13271,GA,"Telfair County, GA",3810,3437,373,9,3726,3463,263,7,3597,3392,205,5,12465,12330,12354,29,119,117,55,207,218,2686,4041,1695,645
13273,GA,"Terrell County, GA",3538,3275,263,7,3542,3320,222,6,3475,3318,157,4,9138,8904,8754,17,91,92,52,156,160,1277,2258,1956,657
13275,GA,"Thomas County, GA",17051,15997,1054,6,17434,16700,734,4,17013,16412,601,3,45785,45815,45561,133,500,529,166,647,666,4115,9587,9640,7930
13277,GA,"Tift County, GA",20599,19561,1038,5,21106,20379,727,3,21053,20469,584,2,41374,41123,41412,139,522,539,122,543,539,4203,8809,8611,4698
13279,GA,"Toombs County, GA",12199,11410,789,6,12067,11524,543,4,12129,11669,460,3,27081,26873,26837,105,371,387,96,442,455,3083,5794,5636,2931
13281,GA,"Towns County, GA",3884,3629,255,6,4037,3875,162,4,4066,3900,166,4,12545,12867,12972,17,86,90,45,229,236,694,2627,3039,2922
13283,GA,"Treutlen County, GA",2667,2505,162,6,2629,2515,114,4,2641,2537,104,3,6396,6382,6365,19,69,67,20,111,119,1045,1778,793,598
13285,GA,"Troup County, GA",37707,35012,2695,7,37206,35577,1629,4,36577,35486,1091,3,69323,69479,70191,184,836,875,240,932,923,5903,16548,14421,9047
13287,GA,"Turner County, GA",3272,3035,237,7,3266,3059,207,6,3172,3043,129,4,8983,8931,8842,25,102,102,34,128,134,1258,2101,2150,677
13289,GA,"Twiggs County, GA",2795,2587,208,7,2769,2625,144,5,2726,2600,126,4,8011,7899,7680,20,74,63,34,156,168,1200,2579,1648,683
13291,GA,"Union County, GA",10581,10121,460,4,11116,10811,305,2,11458,11157,301,2,24798,25560,26388,40,167,167,95,439,442,2338,6458,5530,4756
13293,GA,"Upson County, GA",11403,10660,743,6,11599,11133,466,4,11741,11368,373,3,27740,27673,28086,88,330,330,120,532,527,3246,6607,6164,2736
13295,GA,"Walker County, GA",30661,29161,1500,4,30754,29771,983,3,31180,30239,941,3,67742,68405,68915,188,700,736,241,1001,998,7474,16554,14485,9311
13297,GA,"Walton County, GA",45698,43264,2434,5,47033,45534,1499,3,48037,46703,1334,2,97153,99808,103065,245,1009,1094,268,1149,1183,7837,21674,19791,14860
13299,GA,"Ware County, GA",15350,14503,847,5,15433,14865,568,3,15860,15389,471,3,36225,35547,35614,120,461,481,149,627,625,4466,10273,6283,3510
13301,GA,"Warren County, GA",2647,2469,178,6,2686,2560,126,4,2691,2589,102,3,5208,5214,5155,9,54,52,20,100,102,1084,1466,907,352
13303,GA,"Washington County, GA",6946,6505,441,6,6875,6534,341,5,6967,6695,272,3,19948,19766,19738,49,196,198,56,336,333,2258,6497,3064,2290
13305,GA,"Wayne County, GA",11594,10952,642,5,11864,11418,446,3,12005,11635,370,3,30145,30246,30896,77,336,345,89,452,473,3157,8933,5540,2762
13307,GA,"Webster County, GA",1018,961,57,5,994,949,45,4,985,949,36,3,2352,2356,2328,4,21,17,8,34,33,328,532,601,229
13309,GA,"Wheeler County, GA",1616,1500,116,7,1629,1539,90,5,1657,1574,83,5,7447,7748,7314,11,65,64,19,79,82,1179,2149,637,399
13311,GA,"White County, GA",16300,15596,704,4,16612,16187,425,2,17015,16609,406,2,28108,28393,28806,50,249,258,83,412,426,2925,6137,6358,4302
13313,GA,"Whitfield County, GA",43252,40145,3107,7,43090,41387,1703,4,43134,41498,1636,3,102776,102688,103132,282,1209,1266,228,1134,1116,18454,20932,15564,11716
13315,GA,"Wilcox County, GA",2763,2597,166,6,2720,2589,131,4,2675,2576,99,3,8792,8746,8761,21,74,75,42,149,153,1136,2592,1871,809
13317,GA,"Wilkes County, GA",3653,3408,245,6,3658,3488,170,4,3701,3551,150,4,9556,9516,9599,23,93,93,33,170,171,1336,3176,1613,843
13319,GA,"Wilkinson County, GA",3813,3612,201,5,3656,3504,152,4,3896,3768,128,3,8824,8791,8681,18,95,102,44,153,169,828,3214,1556,624
13321,GA,"Worth County, GA",8842,8363,479,5,8820,8466,354,4,8739,8466,273,3,20738,20557,20424,66,224,204,81,300,304,2211,6417,4445,1589
15000,HI,Hawaii,664085,586179,77906,11,669987,629626,40361,6,676299,652677,23622,3,1451043,1447154,1440196,3835,15518,15788,2838,12133,13328,74468,273929,321607,350418
15001,HI,"Hawaii County, HI",91884,81388,10496,11,93899,88444,5455,5,94246,90813,3433,3,200712,203792,206315,503,2034,2056,430,1944,2077,10285,42111,47704,43240
15003,HI,"Honolulu County/city, HI",450653,404342,46311,10,452578,427310,25268,5,458128,442291,15837,3,1012305,1004673,995638,2748,11054,11256,1963,8346,9276,51255,180820,218647,256030
15007,HI,"Kauai County, HI",36379,30472,5907,16,36189,33242,2947,8,36657,35336,1321,3,73186,73791,73810,171,765,772,144,566,611,4153,15503,17036,15772
15009,HI,"Maui County, HI",85169,69977,15192,17,87321,80630,6691,7,87268,84237,3031,3,164760,164817,164351,413,1664,1703,301,1277,1364,8772,35482,38206,35359
16000,ID,Idaho,901894,852423,49471,5,925409,893169,32240,3,950672,925358,25314,2,1849202,1904314,1939033,5467,21872,22524,3628,17084,18838,104683,314521,420711,345282
16001,ID,"Ada County, ID",260850,246434,14416,5,267054,258509,8545,3,275602,269248,6354,2,498260,512914,518907,1231,4961,5122,868,4007,4394,16433,68936,110566,134694
16003,ID,"Adams County, ID",1783,1613,170,9,1801,1686,115,6,1764,1671,93,5,4425,4632,4817,13,39,40,14,45,53,257,1280,1256,634
16005,ID,"Bannock County, ID",42525,40404,2121,5,42608,41111,1497,3,43837,42641,1196,2,87270,88349,89517,282,1058,1084,191,915,985,3696,14141,21286,15943
16007,ID,"Bear Lake County, ID",3104,2971,133,4,3126,3034,92,2,3292,3207,85,2,6367,6559,6722,23,87,89,27,80,89,283,1541,1499,784
16009,ID,"Benewah County, ID",4182,3861,321,7,4098,3875,223,5,4092,3919,173,4,9576,9941,10370,25,106,111,23,126,144,957,2448,2111,1228
16011,ID,"Bingham County, ID",24040,23096,944,3,24560,23793,767,3,24978,24329,649,2,48106,48898,49923,152,630,653,108,481,537,3067,9642,10400,5623
16013,ID,"Blaine County, ID",12868,11845,1023,7,12909,12451,458,3,13257,12925,332,2,24342,24767,24866,38,171,176,44,147,161,1693,4095,3980,7204
16015,ID,"Boise County, ID",3665,3369,296,8,3748,3552,196,5,3832,3688,144,3,7662,8121,8333,12,41,41,7,80,85,317,1841,2167,1664
16017,ID,"Bonner County, ID",21278,19629,1649,7,21586,20574,1012,4,21888,21093,795,3,47402,49617,51414,97,403,417,98,486,542,2812,10541,12129,9228
16019,ID,"Bonneville County, ID",58792,56364,2428,4,60745,59016,1729,2,62826,61352,1474,2,124716,128045,129496,452,1805,1851,231,1133,1255,5552,18759,26567,23172
16021,ID,"Boundary County, ID",5564,5212,352,6,5646,5405,241,4,5704,5488,216,3,12137,12635,13345,35,153,158,29,141,153,963,3105,2809,1343
16023,ID,"Butte County, ID",1402,1350,52,3,1449,1395,54,3,1491,1446,45,3,2583,2650,2684,9,30,31,10,38,42,205,611,806,279
16025,ID,"Camas County, ID",694,660,34,4,703,681,22,3,725,705,20,2,1083,1129,1153,3,10,10,5,13,14,147,190,213,168
16027,ID,"Canyon County, ID",107738,101287,6451,6,111415,107123,4292,3,114909,111561,3348,2,232998,243774,251065,836,3256,3354,399,1988,2185,19140,42714,50762,29420
16029,ID,"Caribou County, ID",4143,3991,152,3,4104,3979,125,3,4171,4055,116,2,7012,7110,7190,17,96,98,19,92,104,460,1286,1873,843
16031,ID,"Cassia County, ID",12509,12040,469,3,13394,13030,364,2,14052,13738,314,2,24760,25249,25655,96,391,402,45,240,265,2281,4264,5272,2722
16033,ID,"Clark County, ID",380,365,15,3,379,367,12,3,390,376,14,3,791,793,806,3,9,9,0,4,6,180,141,99,100
16035,ID,"Clearwater County, ID",3058,2800,258,8,3032,2840,192,6,3013,2858,155,5,8752,8917,9015,20,73,73,31,127,141,520,2409,2698,1242
16037,ID,"Custer County, ID",2250,2135,115,5,2284,2182,102,4,2255,2182,73,3,4265,4434,4506,9,30,30,14,52,64,423,934,1004,895
16039,ID,"Elmore County, ID",11969,11378,591,4,12292,11846,446,3,12478,12117,361,2,28669,28941,29403,86,425,439,57,233,260,1923,5346,7128,3497
16041,ID,"Franklin County, ID",7218,6956,262,3,7376,7195,181,2,7592,7424,168,2,14284,14676,15189,52,212,219,25,104,118,608,3917,2556,1301
16043,ID,"Fremont County, ID",7960,7662,298,3,8193,7961,232,2,8377,8171,206,2,13414,13606,13978,47,160,166,27,132,145,1012,2520,3418,1878
16045,ID,"Gem County, ID",8562,8048,514,6,8737,8384,353,4,8947,8690,257,2,19274,19832,20418,60,210,214,59,270,297,1603,4513,4224,2796
16047,ID,"Gooding County, ID",8341,8016,325,3,9112,8847,265,2,9689,9460,229,2,15643,15725,15715,35,168,171,52,209,235,2261,3397,2714,1531
16049,ID,"Idaho County, ID",6771,6309,462,6,6831,6503,328,4,6820,6562,258,3,16588,17053,17593,26,121,126,42,219,241,958,4034,4535,2682
16051,ID,"Jefferson County, ID",14269,13769,500,3,14983,14586,397,2,15476,15134,342,2,31077,32253,33428,125,452,468,47,205,226,1437,4277,7384,4412
16053,ID,"Jerome County, ID",12233,11730,503,4,13774,13358,416,3,14367,14011,356,2,24268,24745,25311,94,337,353,35,192,223,3493,4383,4861,2005
16055,ID,"Kootenai County, ID",81974,76137,5837,7,82612,79128,3484,4,84574,81852,2722,3,172790,180146,183578,456,1861,1921,357,1765,1910,7584,31689,47011,31062
16057,ID,"Latah County, ID",19843,18875,968,4,19933,19279,654,3,20417,19915,502,2,39629,40397,40978,109,425,435,64,260,281,803,4735,7387,10123
16059,ID,"Lemhi County, ID",3672,3422,250,6,3711,3518,193,5,3705,3567,138,3,7958,8136,8240,7,53,55,30,139,159,607,1802,2314,1325
16061,ID,"Lewis County, ID",1665,1534,131,7,1671,1579,92,5,1662,1597,65,3,3528,3709,3763,11,44,46,11,52,60,259,702,1132,489
16063,ID,"Lincoln County, ID",2668,2507,161,6,2893,2774,119,4,3019,2915,104,3,5129,5260,5329,10,56,56,3,59,61,623,1135,1187,393
16065,ID,"Madison County, ID",22507,21884,623,2,23378,22867,511,2,23936,23497,439,1,52929,54114,54976,277,1101,1138,44,203,222,958,3796,9149,7938
16067,ID,"Minidoka County, ID",11743,11280,463,3,12505,12134,371,3,12781,12476,305,2,21666,21945,22194,67,274,280,47,216,239,2776,4581,4215,1720
16069,ID,"Nez Perce County, ID",21001,19956,1045,5,20981,20305,676,3,21312,20763,549,2,42141,42509,43004,114,454,467,125,568,628,1995,8804,10960,7415
16071,ID,"Oneida County, ID",2360,2259,101,4,2583,2519,64,2,2696,2628,68,2,4562,4588,4712,8,37,38,11,46,50,291,1051,934,660
16073,ID,"Owyhee County, ID",5584,5246,338,6,6141,5899,242,3,5884,5693,191,3,11994,12348,12613,34,141,142,28,143,156,1965,2423,2389,1039
16075,ID,"Payette County, ID",12071,11416,655,5,12068,11592,476,3,12218,11846,372,3,25583,26377,26956,68,326,332,55,287,317,2282,5898,5243,3047
16077,ID,"Power County, ID",4160,3988,172,4,4377,4220,157,3,4540,4411,129,2,7877,7959,8068,18,86,89,11,79,91,1006,1581,1633,676
16079,ID,"Shoshone County, ID",5500,4987,513,9,5475,5126,349,6,5446,5194,252,4,13195,13659,14012,38,150,154,33,198,214,1107,3530,3833,1076
16081,ID,"Teton County, ID",6737,6346,391,5,7145,6940,205,2,7616,7456,160,2,11735,12294,12544,33,128,132,13,48,56,604,1413,2220,3703
16083,ID,"Twin Falls County, ID",41754,39510,2244,5,43353,41865,1488,3,44257,43091,1166,2,90361,92357,93696,289,1117,1143,234,1004,1136,7392,15658,20560,13384
16085,ID,"Valley County, ID",5718,5255,463,8,5789,5493,296,5,5790,5574,216,3,11842,12264,12464,23,88,91,18,90,104,850,2246,3245,2653
16087,ID,"Washington County, ID",4793,4527,266,5,4853,4645,208,4,4994,4830,164,3,10559,10887,11087,27,97,100,37,168,190,900,2212,2982,1291
17000,IL,Illinois,6349816,5759004,590812,9,6366428,5980444,385984,6,6472663,6176876,295787,4,12786580,12686469,12582032,33454,131658,131491,35347,128282,126625,885321,2226182,2483806,3169569
17001,IL,"Adams County, IL",31302,29301,2001,6,31108,29859,1249,4,30780,29758,1022,3,65612,65146,64725,169,746,746,179,861,851,3475,16058,14639,11810
17003,IL,"Alexander County, IL",1842,1653,189,10,1838,1689,149,8,1808,1695,113,6,5173,5032,4858,10,55,56,23,113,115,527,1441,1383,468
17005,IL,"Bond County, IL",7434,6915,519,7,7497,7149,348,4,7497,7213,284,3,16688,16633,16566,44,143,144,47,199,197,1345,3916,4174,2534
17007,IL,"Boone County, IL",25436,22548,2888,11,25040,22861,2179,8,25074,23471,1603,6,53334,53199,53154,135,528,532,118,477,485,4575,11504,10539,8795
17009,IL,"Brown County, IL",2997,2880,117,3,3015,2935,80,2,3084,3015,69,2,6233,6443,6330,12,59,59,8,71,72,893,1770,1360,601
17011,IL,"Bureau County, IL",16459,15196,1263,7,16441,15608,833,5,16115,15398,717,4,33172,32961,32828,83,332,332,91,469,464,2230,8420,8217,4843
17013,IL,"Calhoun County, IL",2186,2010,176,8,2185,2079,106,4,2182,2095,87,4,4404,4385,4360,6,47,47,17,68,69,241,1352,1159,577
17015,IL,"Carroll County, IL",7473,6931,542,7,7556,7225,331,4,7354,7071,283,3,15667,15674,15529,36,133,133,69,252,255,1376,4128,3627,2263
17017,IL,"Cass County, IL",5844,5447,397,6,5694,5406,288,5,5696,5457,239,4,12985,12798,12657,38,167,167,30,161,158,1320,3660,2184,1599
17019,IL,"Champaign County, IL",107408,100294,7114,6,108953,103518,5435,5,109793,105667,4126,3,205629,206708,206542,524,2082,2086,345,1477,1467,6294,25720,33614,54738
17021,IL,"Christian County, IL",13560,12448,1112,8,13420,12672,748,5,13329,12715,614,4,33950,33721,33436,83,294,295,98,470,466,2569,10141,7138,4413
17023,IL,"Clark County, IL",7347,6737,610,8,7328,6946,382,5,7344,7039,305,4,15423,15354,15229,48,179,180,44,228,226,756,4057,3517,2538
17025,IL,"Clay County, IL",6221,5632,589,9,5937,5598,339,5,5699,5432,267,4,13271,13154,13047,32,154,154,39,189,191,1082,3647,3200,1381
17027,IL,"Clinton County, IL",19762,18590,1172,5,19947,19236,711,3,19990,19400,590,3,36913,36886,36909,96,386,383,96,401,401,2297,8620,9382,6093
17029,IL,"Coles County, IL",23169,21434,1735,7,22904,21707,1197,5,22768,21810,958,4,46761,46809,46334,117,459,460,148,609,618,2465,9852,10352,7856
17031,IL,"Cook County, IL",2603951,2326705,277246,10,2618124,2436432,181692,6,2687539,2552151,135388,5,5261249,5177606,5109292,14092,55476,55365,15800,49864,49015,439740,820019,906703,1489931
17033,IL,"Crawford County, IL",8436,7834,602,7,8433,7996,437,5,8276,7936,340,4,18648,18691,18536,42,174,175,42,236,236,1886,3985,5527,2383
17035,IL,"Cumberland County, IL",5957,5613,344,5,5949,5696,253,4,5957,5754,203,3,10429,10343,10324,22,118,119,27,132,138,525,2890,2581,1423
17037,IL,"DeKalb County, IL",53144,48722,4422,8,53335,50267,3068,5,53959,51668,2291,4,100253,100472,100232,301,1023,1024,231,872,862,4404,15101,20443,19844
17039,IL,"De Witt County, IL",7036,6560,476,6,7129,6770,359,5,7348,7056,292,4,15450,15379,15310,45,155,156,60,235,238,771,4709,3386,2344
17041,IL,"Douglas County, IL",10014,9445,569,5,10177,9787,390,3,10163,9830,333,3,19758,19740,19755,62,264,266,48,223,221,2118,4501,4012,2511
17043,IL,"DuPage County, IL",498432,460331,38101,7,504791,482014,22777,4,524007,504982,19025,3,931244,926448,920901,2387,9260,9245,2088,7361,7257,41827,116233,158756,325349
17045,IL,"Edgar County, IL",8937,8324,613,6,8968,8592,376,4,9155,8843,312,3,16796,16589,16433,39,183,183,56,284,286,1493,4796,3887,2270
17047,IL,"Edwards County, IL",2682,2440,242,9,2544,2406,138,5,2412,2307,105,4,6208,6086,6071,7,62,62,29,93,94,347,1520,1961,589
17049,IL,"Effingham County, IL",19268,17990,1278,6,19543,18774,769,3,19786,19198,588,3,34695,34531,34325,120,423,421,70,435,430,1631,7783,8827,5478
17051,IL,"Fayette County, IL",9758,9014,744,7,9842,9324,518,5,9677,9261,416,4,21483,21447,21305,55,238,236,55,268,270,2071,6259,5012,1916
17053,IL,"Ford County, IL",6191,5779,412,6,6236,5950,286,4,6312,6059,253,4,13517,13491,13249,34,144,145,56,233,237,779,3328,3285,2053
17055,IL,"Franklin County, IL",16011,14310,1701,10,15791,14727,1064,6,15833,15017,816,5,37685,37498,37242,98,358,357,128,598,585,2809,8800,10515,4762
17057,IL,"Fulton County, IL",14633,13365,1268,8,14557,13716,841,5,14620,13913,707,4,33488,33313,33021,87,305,305,126,534,525,2595,9143,8488,4518
17059,IL,"Gallatin County, IL",2028,1830,198,9,1969,1846,123,6,2001,1900,101,5,4938,4907,4855,9,49,49,21,84,87,442,1447,1399,405
17061,IL,"Greene County, IL",5923,5522,401,6,5936,5644,292,4,5901,5659,242,4,11936,11851,11651,24,113,113,37,196,200,804,3838,2544,1422
17063,IL,"Grundy County, IL",25124,22969,2155,8,25388,24042,1346,5,26492,25191,1301,4,52517,52929,53041,124,497,496,127,535,542,2230,11068,12313,9299
17065,IL,"Hamilton County, IL",4245,3941,304,7,4257,4058,199,4,4301,4154,147,3,7997,7923,7984,31,92,93,26,131,133,676,1847,2119,1069
17067,IL,"Hancock County, IL",8097,7538,559,6,8082,7728,354,4,7970,7659,311,3,17547,17388,17244,44,186,186,62,268,266,846,4415,4422,3149
17069,IL,"Hardin County, IL",1302,1172,130,10,1364,1268,96,7,1439,1365,74,5,3641,3650,3597,10,30,30,15,72,75,445,1002,1091,392
17071,IL,"Henderson County, IL",3548,3301,247,7,3560,3415,145,4,3521,3380,141,4,6334,6304,6151,9,51,51,27,105,109,367,2085,1510,903
17073,IL,"Henry County, IL",23827,21932,1895,8,23749,22561,1188,5,23673,22673,1000,4,49172,48868,48419,129,442,441,161,678,677,2694,12017,11836,8355
17075,IL,"Iroquois County, IL",13612,12755,857,6,12998,12368,630,4,12523,11961,562,4,26977,26761,26473,75,247,249,100,432,421,2234,7444,6571,3082
17077,IL,"Jackson County, IL",27284,25145,2139,7,27264,25742,1522,5,27041,25912,1129,4,52906,52666,52617,146,600,600,146,599,595,2710,7409,11198,11057
17079,IL,"Jasper County, IL",4594,4314,280,6,4757,4552,205,4,4860,4682,178,3,9240,9204,9212,22,98,99,29,99,102,520,2452,2263,1289
17081,IL,"Jefferson County, IL",17039,15306,1733,10,16607,15556,1051,6,16387,15627,760,4,36998,36882,36400,88,403,403,126,546,547,2644,8299,10466,4755
17083,IL,"Jersey County, IL",10628,9825,803,7,10647,10176,471,4,10625,10254,371,3,21495,21370,21246,49,203,205,69,320,322,1139,5596,4903,3364
17085,IL,"Jo Daviess County, IL",10489,9613,876,8,10604,10126,478,4,10479,10092,387,3,22057,21932,21758,44,144,145,68,301,303,1280,5897,5182,4147
17087,IL,"Johnson County, IL",4110,3733,377,9,4117,3864,253,6,4083,3864,219,5,13322,13471,13381,31,98,98,32,163,163,1635,3148,3203,1675
17089,IL,"Kane County, IL",262522,238193,24329,9,261416,245801,15615,6,264745,252819,11926,4,516141,516183,514182,1460,5569,5563,1123,4045,3959,47621,76989,93655,122594
17091,IL,"Kankakee County, IL",54173,49312,4861,9,52624,49132,3492,6,52033,49298,2735,5,107250,106652,106074,280,1134,1136,340,1310,1314,7490,24927,24350,14861
17093,IL,"Kendall County, IL",69572,63989,5583,8,70284,66964,3320,4,73203,70254,2949,4,132348,134948,137254,379,1387,1387,170,750,749,5307,20500,28034,29326
17095,IL,"Knox County, IL",21153,19307,1846,8,20595,19232,1363,6,19932,18900,1032,5,49799,49347,48640,125,509,509,160,799,803,3859,12274,11896,6855
17097,IL,"Lake County, IL",365945,336112,29833,8,366404,346754,19650,5,364001,348753,15248,4,713251,712160,709150,1692,6534,6515,1643,5535,5429,43130,94568,114310,217451
17099,IL,"LaSalle County, IL",52950,47896,5054,9,52918,49718,3200,6,52113,49574,2539,4,109421,109139,108078,255,1051,1053,338,1485,1445,7334,27529,28423,14362
17101,IL,"Lawrence County, IL",5832,5256,576,9,5550,5186,364,6,5133,4848,285,5,15258,15216,14914,32,141,142,33,212,210,1765,4137,3887,1500
17103,IL,"Lee County, IL",17166,15984,1182,6,16976,16189,787,4,16695,16035,660,4,34051,34166,33848,78,308,309,103,451,447,2607,8696,9122,4680
17105,IL,"Livingston County, IL",15957,14868,1089,6,15519,14735,784,5,15481,14868,613,4,35779,35741,35521,98,397,398,102,498,491,2492,10598,7939,4238
17107,IL,"Logan County, IL",12122,11290,832,6,11903,11317,586,4,11612,11126,486,4,27899,27970,27591,52,236,235,87,403,398,1906,7037,6640,4159
17109,IL,"McDonough County, IL",12839,11911,928,7,12776,12132,644,5,12782,12255,527,4,27097,26848,26861,67,244,245,96,363,355,821,5454,4965,5342
17111,IL,"McHenry County, IL",163126,149951,13175,8,164803,156995,7808,4,171299,164451,6848,4,309886,311592,311747,769,2947,2941,689,2492,2431,13717,55145,68660,74658
17113,IL,"McLean County, IL",85226,79370,5856,6,86036,81998,4038,4,88860,85712,3148,3,170954,171190,171141,416,1676,1677,308,1394,1375,4190,24299,28312,47627
17115,IL,"Macon County, IL",47300,42577,4723,10,46509,42924,3585,7,45559,43036,2523,5,103756,102649,101483,301,1221,1216,317,1418,1399,5926,25424,23622,16852
17117,IL,"Macoupin County, IL",22007,20466,1541,7,22209,21181,1028,4,22179,21352,827,3,44845,44545,44245,107,430,429,149,640,640,2857,12968,10306,5924
17119,IL,"Madison County, IL",131563,121231,10332,7,132172,125585,6587,5,131598,126670,4928,3,265610,264898,263864,662,2554,2555,797,3291,3233,13030,54017,66106,52992
17121,IL,"Marion County, IL",17129,15528,1601,9,16896,15892,1004,5,16732,15962,770,4,37639,37378,36914,111,466,465,131,631,629,2885,9155,9912,4243
17123,IL,"Marshall County, IL",5079,4706,373,7,5111,4823,288,5,5112,4875,237,4,11706,11686,11678,29,106,106,34,170,177,648,3365,3023,1544
17125,IL,"Mason County, IL",5936,5459,477,8,5935,5612,323,5,5915,5648,267,4,13057,12859,12748,42,128,128,39,241,238,895,3914,3150,1599
17127,IL,"Massac County, IL",5442,4893,549,10,5406,5086,320,5,5367,5110,257,4,14138,13966,13896,32,139,139,49,233,230,1297,3552,4034,1341
17129,IL,"Menard County, IL",6076,5679,397,6,6172,5910,262,4,6177,5954,223,3,12271,12184,12121,28,112,112,35,126,129,371,2930,3246,2118
17131,IL,"Mercer County, IL",7633,7010,623,8,7585,7207,378,5,7553,7241,312,4,15627,15568,15504,27,127,125,40,222,224,842,4332,3977,2109
17133,IL,"Monroe County, IL",18469,17432,1037,5,18653,18052,601,3,18736,18212,524,2,34952,34993,35033,85,286,285,87,365,376,1155,6299,8042,9121
17135,IL,"Montgomery County, IL",11490,10480,1010,8,11348,10716,632,5,11163,10654,509,4,28203,28154,28020,60,264,266,89,414,413,2514,8255,6225,3696
17137,IL,"Morgan County, IL",15933,14829,1104,6,15790,14985,805,5,15634,15007,627,4,32838,32599,32209,78,299,297,104,475,481,2451,8991,6816,4876
17139,IL,"Moultrie County, IL",7290,6909,381,5,7404,7133,271,3,7408,7171,237,3,14476,14509,14323,29,172,173,49,214,217,1322,3252,3307,1947
17141,IL,"Ogle County, IL",24215,22226,1989,8,23786,22385,1401,5,23919,22772,1147,4,51694,51474,51351,117,488,490,128,601,595,3255,12261,12696,7766
17143,IL,"Peoria County, IL",83878,75110,8768,10,83035,77033,6002,7,82158,78032,4126,5,181322,179764,178383,543,2199,2200,495,2042,2023,9588,33607,39020,40342
17145,IL,"Perry County, IL",8116,7339,777,9,7988,7501,487,6,7823,7437,386,4,20882,21033,20588,47,187,187,58,257,255,2500,5654,5333,1777
17147,IL,"Piatt County, IL",8394,7932,462,5,8532,8176,356,4,8632,8337,295,3,16674,16781,16723,41,162,161,37,185,187,740,3764,3590,3650
17149,IL,"Pike County, IL",6763,6358,405,6,6838,6550,288,4,6760,6479,281,4,14641,14609,14484,42,165,165,57,252,247,920,4290,3350,1825
17151,IL,"Pope County, IL",1632,1514,118,7,1687,1606,81,4,1760,1681,79,4,3758,3770,3770,6,27,26,11,52,57,316,1254,914,421
17153,IL,"Pulaski County, IL",1768,1557,211,11,1701,1540,161,9,1658,1543,115,6,5160,5073,4991,14,54,54,25,77,79,404,1507,1306,555
17155,IL,"Putnam County, IL",2952,2704,248,8,2981,2829,152,5,2978,2838,140,4,5631,5596,5572,7,55,56,14,59,64,275,1632,1384,821
17157,IL,"Randolph County, IL",13799,12812,987,7,13752,13140,612,4,13484,13002,482,3,30086,30219,30068,87,292,292,111,424,415,3309,8519,7422,2925
17159,IL,"Richland County, IL",7388,6882,506,6,7088,6772,316,4,7184,6916,268,3,15778,15685,15435,32,124,124,64,261,265,843,3434,4588,2133
17161,IL,"Rock Island County, IL",68828,62261,6567,9,67977,64119,3858,5,67317,64425,2892,4,144359,142992,141527,386,1565,1564,439,1906,1872,10918,29460,35646,23446
17163,IL,"St. Clair County, IL",124713,113223,11490,9,124987,117304,7683,6,123609,118301,5308,4,256823,255022,252671,708,2848,2849,866,3053,3023,13631,48222,62306,52283
17165,IL,"Saline County, IL",9555,8607,948,9,9327,8695,632,6,9296,8828,468,5,23688,23348,23087,58,237,236,74,395,396,2087,5006,6787,3291
17167,IL,"Sangamon County, IL",97057,88967,8090,8,98217,92683,5534,5,97397,93403,3994,4,196122,195422,194534,531,2129,2122,553,2154,2133,9898,37873,42677,46544
17169,IL,"Schuyler County, IL",3146,2945,201,6,3172,3040,132,4,3095,2967,128,4,6871,6822,6746,16,55,56,26,99,96,404,2052,1940,924
17171,IL,"Scott County, IL",2359,2201,158,6,2315,2194,121,5,2292,2182,110,4,4941,4855,4790,10,46,46,14,67,69,210,1556,963,773
17173,IL,"Shelby County, IL",10280,9593,687,6,10202,9754,448,4,9968,9563,405,4,20924,20861,20761,50,189,190,56,272,272,1035,6478,4993,2633
17175,IL,"Stark County, IL",2366,2190,176,7,2373,2241,132,5,2383,2267,116,4,5391,5296,5345,12,58,59,18,82,83,404,1515,1201,756
17177,IL,"Stephenson County, IL",21170,19602,1568,7,20904,19728,1176,5,20727,19794,933,4,44493,44071,43627,106,459,457,136,673,662,2576,10676,11776,6793
17179,IL,"Tazewell County, IL",62164,57068,5096,8,61650,58510,3140,5,61791,59270,2521,4,131073,130563,129911,296,1245,1243,370,1631,1599,6260,28037,32519,25557
17181,IL,"Union County, IL",7212,6622,590,8,7161,6744,417,5,7081,6723,358,5,17182,16937,16767,44,169,169,67,280,286,1337,4382,3878,2818
17183,IL,"Vermilion County, IL",32061,29058,3003,9,31684,29562,2122,6,31891,30296,1595,5,74001,73263,72337,214,854,853,235,1078,1084,4997,21002,16808,8350
17185,IL,"Wabash County, IL",5783,5222,561,9,5514,5250,264,4,5727,5536,191,3,11315,11210,11087,21,108,109,24,158,159,658,2693,3255,1500
17187,IL,"Warren County, IL",8100,7584,516,6,7834,7458,376,4,7783,7478,305,3,16828,16595,16354,81,213,214,60,252,254,1335,3719,3493,2466
17189,IL,"Washington County, IL",9578,9070,508,5,9636,9336,300,3,9756,9520,236,2,13731,13651,13643,39,131,131,39,178,179,785,3307,3636,2253
17191,IL,"Wayne County, IL",6799,6225,574,8,6820,6485,335,4,6950,6680,270,3,16125,15967,15872,31,180,179,45,247,244,1438,3967,4261,1736
17193,IL,"White County, IL",6133,5636,497,8,5988,5687,301,5,6031,5798,233,3,13807,13768,13614,23,113,114,58,252,252,1030,3407,3932,1619
17195,IL,"Whiteside County, IL",27753,25510,2243,8,27450,26090,1360,5,27463,26354,1109,4,55553,55342,54658,161,583,585,188,799,783,3399,14889,13608,7398
17197,IL,"Will County, IL",355453,322825,32628,9,358350,337883,20467,5,371526,354402,17124,4,695844,697985,696757,1702,6748,6727,1591,5695,5599,39246,119617,138820,162906
17199,IL,"Williamson County, IL",31509,28746,2763,8,31203,29432,1771,5,30952,29632,1320,4,67113,66943,66695,158,661,664,193,855,844,3506,14301,17379,12764
17201,IL,"Winnebago County, IL",136180,120514,15666,11,133619,122225,11394,8,133220,125490,7730,5,284928,283559,282188,824,3316,3313,868,3393,3350,22994,60897,65354,45227
17203,IL,"Woodford County, IL",18052,16926,1126,6,18091,17351,740,4,18191,17568,623,3,38395,38210,38128,94,361,359,101,434,436,1484,7280,8124,9059
18000,IN,Indiana,3346344,3102706,243638,7,3355642,3225060,130582,3,3404443,3302632,101811,3,6788799,6813532,6833037,19443,77543,80214,19156,77603,79190,460480,1485995,1301440,1253299
18001,IN,"Adams County, IN",16889,15931,958,5,16883,16477,406,2,17121,16744,377,2,35852,35939,36068,168,624,644,88,400,404,2933,9456,5874,3078
18003,IN,"Allen County, IN",186757,172064,14693,7,186034,178566,7468,4,189481,184053,5428,2,386082,389112,391449,1273,5125,5314,964,4021,4124,24735,70255,79531,74398
18005,IN,"Bartholomew County, IN",43976,41049,2927,6,43226,41874,1352,3,44359,43311,1048,2,82216,82730,83540,258,1039,1069,229,866,888,4682,16918,14501,19626
18007,IN,"Benton County, IN",4191,3963,228,5,4252,4126,126,3,4423,4316,107,2,8716,8714,8719,28,114,119,24,113,115,678,2356,1797,1026
18009,IN,"Blackford County, IN",4863,4469,394,8,4716,4526,190,4,4795,4629,166,3,12111,12056,11919,33,122,123,47,208,216,781,4235,2326,1220
18011,IN,"Boone County, IN",36352,34766,1586,4,37291,36431,860,2,38362,37588,774,2,71134,73006,74164,191,728,751,187,616,627,2591,8792,12061,22901
18013,IN,"Brown County, IN",7584,7062,522,6,7713,7439,274,3,7919,7659,260,3,15482,15573,15570,23,102,106,47,203,210,822,4054,3690,3280
18015,IN,"Carroll County, IN",9473,8872,601,6,9631,9312,319,3,10008,9720,288,2,20331,20502,20555,55,228,233,41,202,211,1549,6022,4541,2084
18017,IN,"Cass County, IN",17759,16524,1235,7,17406,16713,693,4,17385,16822,563,3,37791,37579,37540,95,458,476,117,507,513,3998,10791,7756,3554
18019,IN,"Clark County, IN",62098,57537,4561,7,62255,60077,2178,3,62936,61227,1709,2,121353,122847,124237,344,1342,1390,354,1459,1479,7621,29348,27778,19073
18021,IN,"Clay County, IN",11675,10895,780,6,11592,11142,450,3,11699,11308,391,3,26419,26370,26379,65,287,296,91,362,367,1614,7618,6104,2986
18023,IN,"Clinton County, IN",16854,15885,969,5,16893,16384,509,3,17232,16794,438,2,33174,33025,32843,126,422,438,106,452,464,2840,9771,5712,3218
18025,IN,"Crawford County, IN",4904,4544,360,7,4843,4649,194,4,4836,4668,168,3,10525,10491,10536,19,93,95,38,145,145,1274,3487,1799,872
18027,IN,"Daviess County, IN",16661,16011,650,3,16546,16123,423,2,16713,16328,385,2,33366,33381,33418,100,529,549,92,416,425,4785,6965,6105,2830
18029,IN,"Dearborn County, IN",25536,23738,1798,7,25598,24766,832,3,26033,25354,679,2,50754,50946,51138,140,538,553,136,558,564,3254,13463,9730,8771
18031,IN,"Decatur County, IN",15058,13908,1150,7,14864,14397,467,3,14613,14239,374,2,26465,26322,26416,76,304,310,112,362,360,1461,7909,4705,3702
18033,IN,"DeKalb County, IN",22364,20801,1563,7,22233,21571,662,3,22489,21894,595,2,43297,43369,43731,126,520,540,115,525,535,2637,12667,8398,5447
18035,IN,"Delaware County, IN",52841,48901,3940,7,51551,49300,2251,4,51595,49772,1823,3,111763,111981,112031,270,1042,1080,393,1583,1622,6654,23450,21931,17758
18037,IN,"Dubois County, IN",22750,21700,1050,4,22197,21615,582,2,22045,21552,493,2,43643,43625,43632,130,514,536,100,498,505,2949,11153,8115,7267
18039,IN,"Elkhart County, IN",111287,102748,8539,7,116427,113193,3234,2,118711,115739,2972,2,206983,207066,206890,702,2846,2946,456,2098,2128,23619,45191,35739,26169
18041,IN,"Fayette County, IN",8663,7803,860,9,8470,8060,410,4,8388,8018,370,4,23362,23376,23349,68,235,242,87,395,408,2472,7284,4190,2472
18043,IN,"Floyd County, IN",41612,38859,2753,6,41829,40556,1273,3,42390,41340,1050,2,80509,80606,80714,184,811,839,237,958,987,4801,16949,16620,16653
18045,IN,"Fountain County, IN",7767,7246,521,6,7731,7489,242,3,8011,7790,221,2,16483,16466,16574,38,169,176,52,252,252,1398,5045,3565,1500
18047,IN,"Franklin County, IN",11399,10714,685,6,11303,10966,337,3,11375,11073,302,2,22793,22857,23028,56,237,245,56,288,298,1838,6327,4173,3352
18049,IN,"Fulton County, IN",9744,9092,652,6,9519,9173,346,3,9572,9281,291,3,20469,20380,20327,52,213,221,57,294,300,1745,5566,4404,2281
18051,IN,"Gibson County, IN",19712,18469,1243,6,19355,18826,529,2,20038,19588,450,2,33055,32954,32993,97,359,375,90,445,452,1921,9399,7070,4085
18053,IN,"Grant County, IN",31823,29770,2053,6,31482,30192,1290,4,31699,30667,1032,3,66475,66203,66022,189,718,744,259,1055,1068,5183,16692,13739,8658
18055,IN,"Greene County, IN",13360,12515,845,6,13470,12957,513,3,13678,13160,518,3,30804,30826,31006,73,295,306,121,450,455,2547,8608,7288,3440
18057,IN,"Hamilton County, IN",186215,177364,8851,4,190416,185827,4589,2,195968,191796,4172,2,348966,357330,364921,901,3552,3682,621,2335,2383,6183,32280,49878,135500
18059,IN,"Hancock County, IN",41049,38696,2353,5,41700,40527,1173,2,42932,41828,1104,2,80187,81855,83070,181,718,740,195,765,774,3626,16350,16625,17681
18061,IN,"Harrison County, IN",20104,18818,1286,6,20239,19648,591,2,20538,20025,513,2,39662,39817,39851,89,393,406,112,481,491,2724,11739,8200,5238
18063,IN,"Hendricks County, IN",90873,86198,4675,5,92814,90259,2555,2,95478,93184,2294,2,175575,179555,182534,414,1694,1756,416,1525,1564,5625,30616,33493,45442
18065,IN,"Henry County, IN",22035,20561,1474,6,21922,21135,787,3,22299,21596,703,3,48903,49036,48915,126,469,483,178,705,723,3200,14851,10619,6101
18067,IN,"Howard County, IN",37407,33275,4132,11,35222,32842,2380,6,33651,31969,1682,5,83588,83642,83574,225,913,937,331,1276,1300,5225,21571,18662,11968
18069,IN,"Huntington County, IN",18185,16964,1221,6,18184,17590,594,3,18421,17934,487,2,36646,36792,36834,104,400,414,99,515,520,1800,10588,7457,5252
18071,IN,"Jackson County, IN",23263,21566,1697,7,23464,22692,772,3,23684,23037,647,2,46461,46285,46300,165,633,653,105,562,577,3381,12941,9354,5460
18073,IN,"Jasper County, IN",15643,14519,1124,7,15594,14996,598,3,15970,15440,530,3,32892,33113,33281,86,365,377,97,433,442,1917,10057,6522,3898
18075,IN,"Jay County, IN",8875,8283,592,6,8822,8561,261,3,8888,8649,239,2,20476,20309,20198,69,291,302,60,257,260,1647,6485,3846,1781
18077,IN,"Jefferson County, IN",15059,13922,1137,7,15012,14493,519,3,15114,14692,422,2,33100,33119,32946,79,343,353,91,451,458,2412,9402,6982,4243
18079,IN,"Jennings County, IN",13653,12587,1066,7,13483,12942,541,4,13640,13195,445,3,27581,27507,27536,85,345,354,94,358,357,2102,8061,5860,2924
18081,IN,"Johnson County, IN",83568,78779,4789,5,84888,82476,2412,2,87218,85144,2074,2,162224,164418,165782,448,1811,1875,465,1674,1695,7709,33039,30876,34997
18083,IN,"Knox County, IN",18398,17284,1114,6,18225,17657,568,3,18208,17725,483,2,36248,35964,35789,93,389,401,119,545,555,2738,8575,8368,4509
18085,IN,"Kosciusko County, IN",41659,39042,2617,6,40799,39563,1236,3,40920,39890,1030,2,80155,80323,80826,236,892,923,164,845,863,6577,18695,15306,13025
18087,IN,"LaGrange County, IN",19429,18161,1268,6,20604,20157,447,2,21647,21180,467,2,40530,40538,40866,193,725,749,81,353,360,9436,6691,4787,2435
18089,IN,"Lake County, IN",227902,203979,23923,10,226601,211918,14683,6,228203,217774,10429,4,498932,499327,499689,1388,5384,5567,1553,6075,6211,34286,119068,103211,79665
18091,IN,"LaPorte County, IN",47710,43041,4669,9,46967,44438,2529,5,47120,45382,1738,3,112276,112486,111675,290,1126,1165,365,1463,1492,8368,31353,23585,15493
18093,IN,"Lawrence County, IN",20828,19345,1483,7,20886,20090,796,3,20773,20078,695,3,45012,45045,45222,103,417,432,160,652,669,3573,12115,9909,6304
18095,IN,"Madison County, IN",58862,54096,4766,8,59295,56631,2664,4,60466,58460,2006,3,130195,130979,131744,356,1400,1458,441,1817,1867,9283,36143,27990,17239
18097,IN,"Marion County, IN",496408,456101,40307,8,502338,478125,24213,4,509473,493405,16068,3,976631,971647,969466,3378,13514,13975,2981,10069,10239,83635,175662,169534,209182
18099,IN,"Marshall County, IN",22843,21347,1496,6,22679,22018,661,2,23072,22481,591,2,46076,46175,46332,123,538,558,122,592,597,4446,11411,8559,6309
18101,IN,"Martin County, IN",5445,5206,239,4,5444,5291,153,2,5486,5337,149,2,9803,9799,9803,34,104,105,19,119,120,870,2962,2048,992
18103,IN,"Miami County, IN",15287,14016,1271,8,14842,14122,720,4,14399,13810,589,4,35913,36032,35674,72,354,367,108,459,465,3431,10701,7389,3698
18105,IN,"Monroe County, IN",68388,64504,3884,5,69067,66835,2232,3,71487,69489,1998,2,139571,140135,139745,285,1096,1135,299,1192,1225,5001,17048,20718,38571
18107,IN,"Montgomery County, IN",18737,17744,993,5,18596,18063,533,2,18984,18508,476,2,37942,38061,38273,99,387,400,121,482,490,2447,10834,7321,5226
18109,IN,"Morgan County, IN",35727,33743,1984,5,36552,35387,1165,3,37545,36503,1042,2,71848,72260,72236,185,675,698,209,851,879,5710,19804,14590,9473
18111,IN,"Newton County, IN",6603,6139,464,7,6625,6356,269,4,6782,6538,244,3,13786,13793,13823,35,130,135,58,195,199,1211,4532,3037,1167
18113,IN,"Noble County, IN",23014,21058,1956,8,22162,21375,787,3,21912,21291,621,2,47453,47419,47367,180,645,667,142,523,522,5450,12525,8607,5181
18115,IN,"Ohio County, IN",3182,2943,239,7,3163,3075,88,2,3216,3146,70,2,5922,5992,6114,4,54,56,15,79,81,471,1878,1369,694
18117,IN,"Orange County, IN",8568,7599,969,11,8237,7849,388,4,8264,7983,281,3,19848,19812,19623,58,211,218,81,297,301,2080,6154,3689,1835
18119,IN,"Owen County, IN",9079,8490,589,6,9151,8791,360,3,9436,9137,299,3,21314,21432,21482,45,186,194,61,319,316,2161,6718,4259,2141
18121,IN,"Parke County, IN",6901,6515,386,5,6989,6766,223,3,7102,6886,216,3,16155,16486,16369,38,194,201,35,178,182,1753,4495,3841,1504
18123,IN,"Perry County, IN",9142,8533,609,6,8887,8585,302,3,8797,8525,272,3,19151,19317,19183,43,165,169,58,241,248,1259,6262,4025,2129
18125,IN,"Pike County, IN",6214,5845,369,5,5853,5629,224,3,5919,5731,188,3,12247,12178,12168,31,138,141,39,186,189,1020,3910,2506,1227
18127,IN,"Porter County, IN",84914,77924,6990,8,84495,80973,3522,4,86013,83203,2810,3,173295,174517,174791,393,1572,1629,482,1845,1864,7058,40921,34946,35964
18129,IN,"Posey County, IN",12861,12213,648,5,12962,12590,372,2,13102,12793,309,2,25173,25129,25063,46,220,230,63,273,279,1307,6514,5705,4330
18131,IN,"Pulaski County, IN",6445,6047,398,6,6339,6136,203,3,6581,6411,170,2,12523,12370,12485,26,117,120,35,190,192,1111,3954,2480,1137
18133,IN,"Putnam County, IN",16301,15251,1050,6,16514,15960,554,3,16999,16475,524,3,36679,37016,37301,80,338,349,111,427,443,2663,10075,7443,4348
18135,IN,"Randolph County, IN",11272,10519,753,6,11834,11447,387,3,11597,11251,346,3,24409,24437,24437,69,288,296,86,376,382,1872,7130,5336,2774
18137,IN,"Ripley County, IN",14017,13105,912,6,13628,13210,418,3,12903,12511,392,3,28968,29017,29087,87,336,349,89,384,389,1932,8045,5873,3770
18139,IN,"Rush County, IN",8826,8265,561,6,8843,8573,270,3,8955,8734,221,2,16767,16699,16673,45,180,185,50,219,221,1183,5234,3220,1882
18141,IN,"St. Joseph County, IN",134465,122880,11585,8,132238,126197,6041,4,132460,127958,4502,3,272672,272341,272234,790,3209,3317,741,3276,3360,15956,52541,52037,57038
18143,IN,"Scott County, IN",10538,9630,908,8,10494,10044,450,4,10597,10240,357,3,24371,24437,24588,77,311,320,93,398,407,3183,6963,4359,2223
18145,IN,"Shelby County, IN",23180,21477,1703,7,23253,22486,767,3,23800,23210,590,2,45058,45025,44991,123,435,450,144,593,607,3402,13695,8203,5817
18147,IN,"Spencer County, IN",10409,9816,593,5,10527,10209,318,3,10563,10285,278,2,19835,19875,19967,58,225,233,49,239,246,1217,5842,4389,2724
18149,IN,"Starke County, IN",9815,9010,805,8,9633,9184,449,4,9567,9206,361,3,23380,23378,23258,58,245,254,73,357,356,2317,7194,4636,1908
18151,IN,"Steuben County, IN",20044,18767,1277,6,20182,19625,557,2,20778,20331,447,2,34453,34666,34725,80,318,328,93,387,404,1809,9389,7078,5443
18153,IN,"Sullivan County, IN",8020,7454,566,7,7923,7589,334,4,8018,7716,302,3,20819,20781,20670,45,198,204,51,269,277,1879,6349,4829,1888
18155,IN,"Switzerland County, IN",4840,4442,398,8,4717,4541,176,3,4758,4625,133,2,9742,9849,10006,27,122,126,21,107,107,1015,3461,1651,618
18157,IN,"Tippecanoe County, IN",92415,86285,6130,6,94521,91099,3422,3,97885,95116,2769,2,186369,187566,188717,497,2060,2137,315,1375,1412,7679,27859,25924,42024
18159,IN,"Tipton County, IN",9089,8518,571,6,9056,8757,299,3,9011,8756,255,2,15386,15393,15361,49,166,169,49,222,229,1033,4454,2739,2708
18161,IN,"Union County, IN",3493,3296,197,5,3516,3425,91,2,3600,3512,88,2,7081,7014,6952,20,74,75,22,108,111,610,2030,1509,1030
18163,IN,"Vanderburgh County, IN",92814,86071,6743,7,92510,88844,3666,4,93004,90191,2813,3,180331,180267,179744,525,2100,2170,570,2379,2437,11142,38933,39497,33508
18165,IN,"Vermillion County, IN",6645,6137,508,7,6556,6267,289,4,6604,6365,239,3,15409,15440,15451,48,160,163,57,218,223,933,4482,3668,1800
18167,IN,"Vigo County, IN",46540,42819,3721,8,45984,43837,2147,4,46094,44458,1636,3,106119,106084,106006,305,1106,1144,293,1381,1424,7126,23086,21316,17243
18169,IN,"Wabash County, IN",14571,13664,907,6,14526,14057,469,3,14626,14227,399,2,30936,30897,30828,75,285,294,100,523,538,2154,9037,5836,4225
18171,IN,"Warren County, IN",3990,3768,222,5,4021,3907,114,2,4129,4023,106,2,8424,8459,8461,27,79,81,28,124,130,392,2604,1955,1089
18173,IN,"Warrick County, IN",32036,30264,1772,5,32213,31292,921,2,32592,31752,840,2,63996,64623,65185,158,645,670,192,790,819,2392,12395,14677,14395
18175,IN,"Washington County, IN",13653,12689,964,7,13662,13196,466,3,13839,13471,368,2,28242,28151,28224,80,309,319,66,349,364,2593,8252,6106,2497
18177,IN,"Wayne County, IN",30338,28249,2089,6,29818,28654,1164,3,29809,28881,928,3,66513,66490,66273,204,787,807,247,1095,1105,5387,16687,14565,8844
18179,IN,"Wells County, IN",13965,13141,824,5,13987,13591,396,2,14353,14022,331,2,28167,28177,28335,68,336,347,78,380,385,1292,8158,6129,3428
18181,IN,"White County, IN",13258,12571,687,5,13239,12852,387,2,13419,13084,335,2,24668,24662,24598,69,285,298,86,345,355,1840,6745,5380,2985
18183,IN,"Whitley County, IN",17390,16336,1054,6,17425,16911,514,2,17877,17445,432,2,34338,34492,34627,94,372,388,81,374,388,1864,8679,7690,5474
19000,IA,Iowa,1673589,1587341,86248,5,1690368,1626168,64200,3,1716894,1669933,46961,2,3190571,3197689,3200517,9103,36021,36928,8074,35560,35369,152380,648873,688911,629720
19001,IA,"Adair County, IA",4217,4055,162,3,4327,4205,122,2,4345,4254,91,2,7494,7538,7494,23,92,94,17,121,124,280,2131,1842,1027
19003,IA,"Adams County, IA",2046,1970,76,3,2058,2003,55,2,2131,2089,42,2,3710,3642,3611,13,45,43,9,50,57,146,960,968,595
19005,IA,"Allamakee County, IA",7061,6710,351,5,7095,6802,293,4,7128,6859,269,3,14068,13968,13960,63,195,198,49,209,203,944,4008,3139,1696
19007,IA,"Appanoose County, IA",5904,5595,309,5,6009,5777,232,3,6072,5898,174,2,12285,12266,12094,23,120,122,37,206,199,792,3082,3160,1637
19009,IA,"Audubon County, IA",3009,2908,101,3,3071,2983,88,2,3085,3015,70,2,5681,5665,5598,18,61,59,14,76,78,332,1458,1383,868
19011,IA,"Benton County, IA",12849,12209,640,5,13014,12494,520,4,13187,12792,395,3,25534,25719,25711,50,257,268,54,284,268,1027,6578,6346,3852
19013,IA,"Black Hawk County, IA",67468,63393,4075,6,67581,64792,2789,4,68037,66054,1983,2,131034,130606,130274,436,1613,1655,368,1464,1485,6599,24857,27499,24704
19015,IA,"Boone County, IA",14504,13927,577,4,14705,14244,461,3,14924,14586,338,2,26700,26776,26609,59,261,267,79,332,335,1108,6104,6869,4847
19017,IA,"Bremer County, IA",13712,13189,523,3,13882,13478,404,2,14047,13723,324,2,25003,25122,25259,63,245,255,69,297,287,573,4959,5288,5492
19019,IA,"Buchanan County, IA",11149,10651,498,4,11282,10905,377,3,11369,11054,315,2,20606,20697,20714,67,272,276,47,240,231,859,4825,5130,2949
19021,IA,"Buena Vista County, IA",11677,11258,419,3,11646,11311,335,2,11802,11527,275,2,20809,20767,20600,58,295,301,54,198,205,2698,4070,3477,2831
19023,IA,"Butler County, IA",7700,7350,350,4,7934,7665,269,3,8246,8016,230,2,14332,14362,14269,40,146,149,37,202,197,594,3708,3902,1938
19025,IA,"Calhoun County, IA",4080,3917,163,4,4110,3964,146,3,4202,4095,107,2,9882,9884,9725,22,89,93,27,142,139,423,2695,2458,1477
19027,IA,"Carroll County, IA",10556,10147,409,3,10654,10357,297,2,10832,10619,213,2,20721,20752,20567,69,241,244,60,283,286,814,4813,5340,3118
19029,IA,"Cass County, IA",6767,6509,258,3,6819,6592,227,3,6895,6725,170,2,13118,13065,13104,27,117,121,51,223,216,997,3164,3228,1959
19031,IA,"Cedar County, IA",10414,9969,445,4,10448,10093,355,3,10572,10292,280,2,18491,18444,18399,45,174,176,47,206,210,584,5086,4601,2861
19033,IA,"Cerro Gordo County, IA",23139,21959,1180,5,22674,21796,878,3,22469,21847,622,2,43023,42761,42409,111,434,437,146,624,618,1999,10283,11166,7360
19035,IA,"Cherokee County, IA",6203,5972,231,3,6180,5992,188,3,6166,6026,140,2,11663,11532,11491,31,130,131,36,188,183,537,3324,2654,1776
19037,IA,"Chickasaw County, IA",6293,6006,287,4,6436,6228,208,3,6618,6452,166,2,11990,11899,11716,41,145,145,34,170,164,546,3668,2472,1505
19039,IA,"Clarke County, IA",4780,4528,252,5,4940,4750,190,3,5010,4864,146,2,9726,9756,9692,26,118,120,27,144,137,986,2644,1802,935
19041,IA,"Clay County, IA",8395,8025,370,4,8555,8272,283,3,8584,8354,230,2,16335,16428,16475,43,158,162,61,206,205,512,3803,4248,2683
19043,IA,"Clayton County, IA",9689,9149,540,5,9702,9255,447,4,9625,9257,368,3,17030,17047,17027,63,192,196,44,250,240,1118,5369,3698,2140
19045,IA,"Clinton County, IA",22069,20614,1455,6,22080,21027,1053,4,22347,21572,775,3,46432,46526,46344,136,522,536,136,610,621,2599,12180,10735,6899
19047,IA,"Crawford County, IA",7948,7539,409,5,7856,7488,368,4,7871,7553,318,4,16490,16243,16123,62,214,216,43,185,184,1994,3904,2970,1794
19049,IA,"Dallas County, IA",50843,49070,1773,3,52398,51029,1369,2,54305,53221,1084,2,100473,104069,108016,304,1303,1356,174,606,606,2596,11677,17008,31827
19051,IA,"Davis County, IA",4127,3965,162,3,4210,4083,127,3,4323,4219,104,2,9112,9146,9130,30,153,158,22,97,93,1157,1631,1773,1080
19053,IA,"Decatur County, IA",4210,4052,158,3,4313,4182,131,3,4282,4176,106,2,7605,7660,7683,11,79,85,22,97,100,476,1774,1216,1245
19055,IA,"Delaware County, IA",10417,10012,405,3,10488,10173,315,3,10571,10328,243,2,17456,17531,17568,42,192,196,43,208,203,942,5207,3648,2268
19057,IA,"Des Moines County, IA",18631,17272,1359,7,18548,17497,1051,5,18322,17556,766,4,38816,38507,38293,109,420,430,125,530,535,1923,8759,10563,5964
19059,IA,"Dickinson County, IA",9802,9314,488,5,10254,9891,363,3,10722,10423,299,2,17766,17852,18028,39,155,158,52,238,235,578,3513,4814,4093
19061,IA,"Dubuque County, IA",55201,52046,3155,5,55505,53303,2202,4,56523,54920,1603,2,99291,98815,98677,279,1076,1104,230,1058,1046,4124,21391,19311,21189
19063,IA,"Emmet County, IA",5049,4804,245,4,4963,4781,182,3,4952,4810,142,2,9335,9318,9176,21,91,92,37,149,144,674,2281,2545,1074
19065,IA,"Fayette County, IA",10269,9719,550,5,10254,9820,434,4,10381,10054,327,3,19445,19309,19294,68,195,201,63,289,281,1009,5773,4458,2334
19067,IA,"Floyd County, IA",8256,7769,487,5,8283,7962,321,3,8387,8142,245,2,15590,15449,15337,51,167,172,47,226,219,781,4218,3648,2208
19069,IA,"Franklin County, IA",5600,5392,208,3,5680,5489,191,3,5651,5507,144,2,9997,9952,9916,36,137,139,29,158,159,644,2499,2602,1264
19071,IA,"Fremont County, IA",3705,3593,112,3,3756,3658,98,2,3756,3666,90,2,6567,6575,6464,17,58,59,16,93,93,250,1739,1904,853
19073,IA,"Greene County, IA",5323,5101,222,4,5381,5214,167,3,5415,5304,111,2,8752,8733,8741,23,90,94,21,120,119,423,2307,2207,1274
19075,IA,"Grundy County, IA",6305,6036,269,4,6377,6166,211,3,6425,6264,161,2,12334,12371,12356,34,132,134,33,163,163,395,2849,3129,2232
19077,IA,"Guthrie County, IA",5404,5140,264,4,5539,5328,211,3,5678,5518,160,2,10613,10586,10647,22,91,91,40,147,149,426,2682,2902,1558
19079,IA,"Hamilton County, IA",6792,6499,293,4,6862,6600,262,3,6952,6759,193,2,15008,14883,14820,39,178,180,51,211,202,689,3502,3842,2571
19081,IA,"Hancock County, IA",5767,5504,263,4,5770,5572,198,3,5757,5625,132,2,10757,10685,10685,31,121,126,30,143,141,636,2814,2697,1568
19083,IA,"Hardin County, IA",7793,7441,352,4,7857,7562,295,3,7887,7654,233,3,16820,16719,16567,42,142,146,53,263,273,938,4400,4538,2419
19085,IA,"Harrison County, IA",6989,6709,280,4,7090,6841,249,3,7179,6988,191,2,14564,14683,14658,44,157,159,43,241,230,793,3944,3451,1960
19087,IA,"Henry County, IA",9481,8988,493,5,9556,9195,361,3,9540,9263,277,2,20451,20390,20196,51,180,181,57,279,273,1132,5071,4758,3033
19089,IA,"Howard County, IA",5110,4888,222,4,5168,4988,180,3,5273,5109,164,3,9492,9500,9533,29,128,129,17,129,130,538,2594,2094,1163
19091,IA,"Humboldt County, IA",4948,4744,204,4,4988,4832,156,3,4958,4837,121,2,9595,9637,9572,22,112,113,22,135,136,463,2530,2498,1228
19093,IA,"Ida County, IA",3987,3847,140,3,4003,3889,114,2,3997,3909,88,2,7019,6974,6888,21,69,70,18,117,113,347,1866,1580,905
19095,IA,"Iowa County, IA",10084,9649,435,4,10017,9673,344,3,9869,9622,247,2,16654,16574,16475,36,170,174,61,232,230,632,4237,4038,2676
19097,IA,"Jackson County, IA",10614,9981,633,6,10680,10201,479,4,10745,10401,344,3,19452,19397,19324,49,193,200,51,264,266,891,5773,4424,2659
19099,IA,"Jasper County, IA",19228,18226,1002,5,19312,18561,751,3,18747,18184,563,3,37810,37874,37938,114,402,412,116,464,463,1554,10572,9334,5079
19101,IA,"Jefferson County, IA",9817,9287,530,5,10015,9642,373,3,10042,9794,248,2,15693,15762,15698,45,143,144,46,209,200,829,2859,3395,4389
19103,IA,"Johnson County, IA",84763,80767,3996,4,85233,82375,2858,3,86913,84948,1965,2,153042,155016,156420,402,1618,1659,191,880,886,3392,13855,24127,48734
19105,IA,"Jones County, IA",10249,9678,571,5,10314,9900,414,4,10453,10120,333,3,20653,20839,20848,49,194,200,48,239,236,786,5677,5086,3200
19107,IA,"Keokuk County, IA",5156,4907,249,4,5229,5021,208,4,5231,5073,158,3,10012,9924,9904,29,99,103,29,154,153,494,3011,2330,1197
19109,IA,"Kossuth County, IA",8124,7823,301,3,8211,7970,241,2,8354,8163,191,2,14794,14524,14475,31,157,160,40,210,209,673,3672,4158,1981
19111,IA,"Lee County, IA",15677,14669,1008,6,15389,14568,821,5,14957,14293,664,4,33520,33208,32840,75,340,352,106,513,513,1608,8929,8859,4619
19113,IA,"Linn County, IA",119698,112250,7448,6,120272,114883,5389,4,121518,117808,3710,3,230411,229458,229033,666,2558,2622,512,2205,2185,7895,40139,53602,53076
19115,IA,"Louisa County, IA",5955,5668,287,4,5918,5688,230,3,5931,5748,183,3,10821,10747,10677,27,104,106,23,120,119,1174,2832,2424,1162
19117,IA,"Lucas County, IA",4622,4456,166,3,4637,4506,131,2,4667,4567,100,2,8620,8696,8689,25,104,108,31,135,126,433,2605,2100,903
19119,IA,"Lyon County, IA",6852,6684,168,2,7017,6871,146,2,7099,6970,129,1,11927,12061,12179,44,172,169,23,114,108,482,3114,2610,1486
19121,IA,"Madison County, IA",8376,7907,469,5,8562,8215,347,4,8824,8549,275,3,16628,16789,17036,47,178,182,28,170,173,393,3748,4244,2758
19123,IA,"Mahaska County, IA",11869,11315,554,4,12086,11684,402,3,12287,11988,299,2,22147,21944,21946,62,233,241,76,285,286,1179,5807,4606,3080
19125,IA,"Marion County, IA",17985,17245,740,4,18687,18159,528,2,19311,18913,398,2,33408,33444,33642,86,357,367,78,378,382,1323,7415,6559,6834
19127,IA,"Marshall County, IA",17564,16347,1217,6,17437,16431,1006,5,17474,16556,918,5,40093,39899,39879,122,484,492,125,564,547,3911,9171,7968,5498
19129,IA,"Mills County, IA",6976,6702,274,3,7058,6835,223,3,7157,6992,165,2,14399,14464,14553,35,140,140,43,156,156,486,3191,3579,2914
19131,IA,"Mitchell County, IA",6066,5864,202,3,5865,5705,160,2,5904,5783,121,2,10588,10563,10532,32,127,129,29,157,155,520,2501,2619,1542
19133,IA,"Monona County, IA",4379,4175,204,4,4446,4270,176,4,4434,4307,127,2,8746,8595,8486,17,92,93,38,185,179,448,2479,2364,937
19135,IA,"Monroe County, IA",3955,3754,201,5,3979,3831,148,3,4051,3937,114,2,7597,7595,7550,28,87,90,28,121,118,336,2092,1719,1023
19137,IA,"Montgomery County, IA",4864,4642,222,4,4914,4732,182,3,5002,4879,123,2,10330,10325,10205,23,100,100,37,176,171,550,2446,2731,1316
19139,IA,"Muscatine County, IA",21343,20107,1236,5,20982,20091,891,4,21178,20551,627,3,43141,42688,42377,104,456,469,128,502,509,2983,10026,9125,6573
19141,IA,"O'Brien County, IA",8109,7842,267,3,8156,7934,222,2,8196,8020,176,2,14154,14062,14060,42,183,188,54,229,220,813,3535,3266,2058
19143,IA,"Osceola County, IA",3508,3409,99,2,3554,3477,77,2,3646,3582,64,1,6202,6163,6036,13,57,58,16,94,94,495,1635,1464,738
19145,IA,"Page County, IA",6207,5903,304,4,6356,6121,235,3,6513,6354,159,2,15196,15215,15143,28,132,134,48,213,218,886,4341,4023,1933
19147,IA,"Palo Alto County, IA",4559,4354,205,4,4546,4409,137,3,4530,4416,114,2,8989,8909,8764,20,106,109,25,140,139,403,1814,2512,1436
19149,IA,"Plymouth County, IA",14356,13849,507,3,14586,14188,398,2,14897,14586,311,2,25689,25714,25681,59,275,281,66,283,279,963,6031,6044,4067
19151,IA,"Pocahontas County, IA",4220,4075,145,3,4251,4134,117,2,4317,4225,92,2,7067,7057,7053,17,74,74,26,102,111,522,1819,1788,853
19153,IA,"Polk County, IA",264856,249212,15644,5,270147,259270,10877,4,278130,270658,7472,2,492997,497675,501089,1532,6290,6463,1109,4436,4442,24393,80903,95992,123509
19155,IA,"Pottawattamie County, IA",47165,44721,2444,5,47425,45605,1820,3,48033,46712,1321,2,93670,93434,93173,273,980,1001,256,1185,1174,6351,20559,21874,14468
19157,IA,"Poweshiek County, IA",9781,9310,471,4,10068,9664,404,4,10331,10048,283,2,18628,18603,18467,35,173,182,61,243,241,705,4659,3149,3585
19159,IA,"Ringgold County, IA",2376,2286,90,3,2411,2337,74,3,2377,2323,54,2,4642,4626,4670,14,48,48,24,104,103,219,1289,1084,661
19161,IA,"Sac County, IA",5179,5000,179,3,5252,5094,158,3,5300,5172,128,2,9794,9745,9673,21,101,108,31,155,151,446,2529,2730,1259
19163,IA,"Scott County, IA",86961,81187,5774,6,87631,83375,4256,4,89009,86166,2843,3,174596,174278,173924,510,1910,1957,417,1921,1896,7167,32952,38401,39694
19165,IA,"Shelby County, IA",6357,6132,225,3,6401,6216,185,2,6482,6337,145,2,11723,11773,11645,28,114,116,47,174,174,544,2913,3050,1835
19167,IA,"Sioux County, IA",21199,20652,547,2,22038,21558,480,2,22514,22094,420,1,35887,35991,36050,110,503,512,55,296,283,1690,6203,6700,6574
19169,IA,"Story County, IA",56797,54788,2009,3,57779,56226,1553,2,59683,58481,1202,2,98645,99666,99673,200,796,822,121,608,614,1643,8786,15127,26685
19171,IA,"Tama County, IA",9245,8781,464,5,9194,8807,387,4,9238,8935,303,3,17077,16874,16903,47,196,200,70,245,245,1083,4787,3853,1927
19173,IA,"Taylor County, IA",3078,2968,110,3,3128,3039,89,2,3164,3102,62,2,5865,5873,5858,16,69,65,23,94,99,376,1580,1432,702
19175,IA,"Union County, IA",6172,5819,353,5,6094,5849,245,4,6139,5971,168,2,12132,12036,11887,33,112,115,34,182,181,741,2737,2935,1886
19177,IA,"Van Buren County, IA",3675,3510,165,4,3665,3539,126,3,3710,3606,104,2,7217,7261,7256,22,98,101,16,94,94,616,1930,1685,822
19179,IA,"Wapello County, IA",17371,16352,1019,5,17013,16251,762,4,16964,16414,550,3,35330,35283,35043,114,449,468,153,486,492,2885,8786,7765,4586
19181,IA,"Warren County, IA",27783,26544,1239,4,28564,27602,962,3,29503,28787,716,2,52588,53487,54327,129,563,580,107,524,525,1446,10097,11618,11055
19183,IA,"Washington County, IA",11424,10964,460,4,11569,11178,391,3,11785,11480,305,2,22540,22494,22571,66,290,301,68,287,283,1233,5622,4795,3602
19185,IA,"Wayne County, IA",2794,2672,122,4,2847,2754,93,3,2945,2870,75,2,6504,6511,6467,31,88,88,26,100,94,459,1844,1399,661
19187,IA,"Webster County, IA",18680,17719,961,5,18667,17894,773,4,18954,18391,563,3,36985,37178,36626,123,429,439,120,541,537,2127,8735,9189,4980
19189,IA,"Winnebago County, IA",5051,4735,316,6,5009,4820,189,3,5045,4910,135,2,10662,10664,10617,26,105,106,36,151,152,411,2383,2693,1739
19191,IA,"Winneshiek County, IA",11142,10610,532,4,11472,11042,430,3,11524,11164,360,3,20037,19915,19974,46,170,176,41,204,202,544,4478,4149,4047
19193,IA,"Woodbury County, IA",54622,51803,2819,5,55254,53118,2136,3,56374,54832,1542,2,105904,105816,105671,382,1404,1442,294,1141,1157,8231,21887,21372,15668
19195,IA,"Worth County, IA",4095,3879,216,5,4035,3881,154,3,4029,3921,108,2,7435,7380,7319,15,78,79,11,94,93,368,1917,1998,1070
19197,IA,"Wright County, IA",6982,6711,271,3,6709,6455,254,3,6627,6457,170,2,12915,12811,12681,49,158,166,41,194,191,653,3277,3262,1731
20000,KS,Kansas,1503002,1415445,87557,5,1500677,1451204,49473,3,1504932,1464834,40098,2,2937919,2937922,2937150,8510,34281,34968,6990,32746,32960,161293,493339,606084,661235
20001,KS,"Allen County, KS",6434,6089,345,5,6496,6292,204,3,6312,6130,182,2,12532,12526,12579,37,135,138,30,153,158,630,3104,3240,1605
20003,KS,"Anderson County, KS",4308,4133,175,4,4640,4521,119,2,4356,4257,99,2,7843,7800,7776,16,87,87,28,108,113,753,1965,1641,858
20005,KS,"Atchison County, KS",6896,6430,466,6,6782,6518,264,3,6789,6552,237,3,16318,16257,16108,38,170,172,35,177,186,615,4315,2987,2252
20007,KS,"Barber County, KS",2325,2250,75,3,2307,2261,46,2,2276,2229,47,2,4203,4099,4122,10,45,45,17,82,81,254,1000,937,719
20009,KS,"Barton County, KS",13719,13092,627,4,13350,12951,399,3,13133,12788,345,2,25419,25239,25080,71,324,332,81,389,387,1976,5358,6448,3634
20011,KS,"Bourbon County, KS",6731,6348,383,5,6503,6256,247,3,6275,6057,218,3,14333,14336,14493,50,214,218,55,206,206,937,2992,3322,2233
20013,KS,"Brown County, KS",5168,4940,228,4,5142,5000,142,2,5089,4969,120,2,9482,9453,9364,20,105,110,34,167,170,418,2446,2343,1228
20015,KS,"Butler County, KS",32590,30453,2137,6,32566,31401,1165,3,32766,31856,910,2,67390,67958,68240,148,660,674,175,774,777,2787,11754,15410,14266
20017,KS,"Chase County, KS",1460,1381,79,5,1380,1346,34,2,1392,1362,30,2,2574,2598,2548,7,23,23,8,33,36,118,580,584,532
20019,KS,"Chautauqua County, KS",1489,1398,91,6,1465,1406,59,4,1431,1391,40,2,3385,3391,3415,8,31,31,20,49,47,291,814,959,369
20021,KS,"Cherokee County, KS",10035,9513,522,5,9910,9612,298,3,9881,9622,259,2,19297,19208,19088,48,222,227,59,327,325,1569,4311,4931,2642
20023,KS,"Cheyenne County, KS",1308,1280,28,2,1295,1271,24,1,1259,1229,30,2,2615,2624,2583,11,36,36,14,56,61,151,642,709,414
20025,KS,"Clark County, KS",1142,1119,23,2,1133,1112,21,1,1110,1088,22,2,1974,1958,1933,4,17,17,6,36,36,80,412,534,386
20027,KS,"Clay County, KS",3830,3661,169,4,3790,3689,101,2,3744,3646,98,2,8122,8091,8043,22,88,88,24,121,126,330,2037,1823,1457
20029,KS,"Cloud County, KS",3864,3708,156,4,3899,3787,112,2,3832,3729,103,2,9008,8954,8946,32,114,114,30,152,155,300,1910,2466,1344
20031,KS,"Coffey County, KS",3957,3754,203,5,3979,3847,132,3,3783,3652,131,3,8356,8343,8280,16,84,85,29,110,109,362,1912,2267,1336
20033,KS,"Comanche County, KS",870,841,29,3,897,877,20,2,869,850,19,2,1680,1660,1681,3,11,11,7,34,31,56,426,601,240
20035,KS,"Cowley County, KS",16881,15783,1098,6,16699,16113,586,3,16444,15958,486,3,34524,34652,34453,93,397,407,103,490,488,1856,6851,8645,5521
20037,KS,"Crawford County, KS",19047,18002,1045,5,18929,18313,616,3,19088,18533,555,2,38951,39033,39078,114,412,425,126,577,577,1590,6811,7980,7065
20039,KS,"Decatur County, KS",1231,1187,44,3,1207,1175,32,2,1180,1146,34,2,2765,2764,2689,7,20,21,4,47,50,133,673,768,452
20041,KS,"Dickinson County, KS",8921,8495,426,4,9066,8789,277,3,8647,8406,241,2,18368,18483,18430,38,190,196,50,247,247,865,4101,4849,3180
20043,KS,"Doniphan County, KS",4160,3969,191,4,4096,3979,117,2,4030,3926,104,2,7463,7442,7440,10,56,57,22,104,106,438,1701,1889,927
20045,KS,"Douglas County, KS",64356,60528,3828,5,64798,62717,2081,3,66297,64587,1710,2,118777,119480,119964,241,1013,1033,210,887,907,2613,13046,17617,36544
20047,KS,"Edwards County, KS",1468,1425,43,2,1463,1431,32,2,1392,1360,32,2,2883,2800,2739,6,34,35,15,79,79,265,707,740,380
20049,KS,"Elk County, KS",1174,1117,57,4,1159,1124,35,3,1174,1142,32,2,2474,2431,2441,2,16,16,10,44,48,227,670,558,319
20051,KS,"Ellis County, KS",17130,16553,577,3,17181,16836,345,2,17032,16695,337,2,28943,28897,28941,79,330,337,61,307,305,1062,4888,5188,6660
20053,KS,"Ellsworth County, KS",2719,2635,84,3,2687,2624,63,2,2630,2569,61,2,6369,6320,6355,16,53,53,22,110,111,385,1595,1681,962
20055,KS,"Finney County, KS",20669,19986,683,3,20342,19898,444,2,20483,20058,425,2,38302,38066,37650,128,543,555,77,333,335,6388,5447,6820,4024
20057,KS,"Ford County, KS",17351,16783,568,3,17686,17295,391,2,17851,17479,372,2,34208,34121,33848,147,559,570,64,321,330,5141,4962,6289,4223
20059,KS,"Franklin County, KS",14304,13539,765,5,14563,14100,463,3,14872,14509,363,2,26008,26021,25992,62,263,269,66,316,326,1255,6526,5609,4004
20061,KS,"Geary County, KS",11709,10891,818,7,11435,10937,498,4,11358,10931,427,3,36751,36112,35691,204,1030,1058,57,255,248,1216,4880,8893,4696
20063,KS,"Gove County, KS",1468,1430,38,2,1460,1432,28,1,1370,1341,29,2,2707,2735,2717,9,29,29,8,57,55,109,753,679,376
20065,KS,"Graham County, KS",1140,1089,51,4,1136,1102,34,3,1191,1163,28,2,2408,2408,2411,5,24,25,6,35,36,110,628,565,467
20067,KS,"Grant County, KS",3115,2990,125,4,2957,2864,93,3,2820,2738,82,2,7326,7318,7197,17,93,94,11,71,74,918,1043,1374,1058
20069,KS,"Gray County, KS",3252,3182,70,2,3229,3171,58,1,3154,3092,62,2,5646,5672,5729,22,85,85,12,64,65,787,804,1110,810
20071,KS,"Greeley County, KS",823,809,14,1,827,816,11,1,794,782,12,1,1274,1280,1223,3,14,14,7,30,31,98,189,282,236
20073,KS,"Greenwood County, KS",3123,2959,164,5,3037,2950,87,2,3026,2953,73,2,5965,5922,5939,11,55,56,24,102,102,335,1602,1675,772
20075,KS,"Hamilton County, KS",1623,1597,26,1,1632,1609,23,1,1628,1601,27,1,2489,2468,2430,7,32,32,9,27,30,306,650,357,317
20077,KS,"Harper County, KS",2799,2677,122,4,2767,2692,75,2,2783,2724,59,2,5465,5329,5323,20,59,59,20,111,113,410,1433,1280,630
20079,KS,"Harvey County, KS",16869,15975,894,5,16977,16466,511,3,17120,16687,433,2,33998,33827,33801,90,352,360,85,464,464,1881,5233,8237,7222
20081,KS,"Haskell County, KS",2253,2202,51,2,2231,2190,41,1,2182,2140,42,1,3759,3646,3576,7,40,40,5,28,27,666,559,816,368
20083,KS,"Hodgeman County, KS",1021,995,26,2,1035,1016,19,1,1028,1007,21,2,1739,1750,1755,8,22,23,0,23,23,109,310,468,384
20085,KS,"Jackson County, KS",7277,6888,389,5,7283,7088,195,2,7286,7115,171,2,13241,13270,13286,36,155,160,29,154,156,505,3560,2932,1878
20087,KS,"Jefferson County, KS",10294,9799,495,4,10396,10080,316,3,10381,10103,278,2,18320,18419,18344,41,165,169,45,212,214,667,5079,4023,3186
20089,KS,"Jewell County, KS",1256,1219,37,2,1238,1209,29,2,1188,1157,31,2,2936,2946,2898,10,25,25,10,43,46,158,808,778,428
20091,KS,"Johnson County, KS",343574,326260,17314,5,345753,336251,9502,2,349503,341465,8038,2,611101,614848,619195,1740,6814,6951,1033,4843,4881,15307,56510,107402,231149
20093,KS,"Kearny County, KS",2035,1984,51,2,2044,2010,34,1,2007,1969,38,1,3961,3892,3855,11,57,58,8,40,41,523,838,536,451
20095,KS,"Kingman County, KS",3269,3096,173,5,3282,3180,102,3,3277,3197,80,2,7412,7280,7193,17,74,74,53,246,243,471,1675,2000,1186
20097,KS,"Kiowa County, KS",1252,1213,39,3,1232,1206,26,2,1213,1186,27,2,2452,2408,2404,7,27,27,7,32,31,189,462,550,391
20099,KS,"Labette County, KS",9708,9164,544,5,9438,9108,330,3,9413,9126,287,3,20165,19929,19757,65,228,233,60,291,296,1365,4282,5029,3063
20101,KS,"Lane County, KS",759,737,22,2,748,732,16,2,730,709,21,2,1569,1572,1556,2,17,17,5,32,31,46,307,470,257
20103,KS,"Leavenworth County, KS",36857,34724,2133,5,37038,35784,1254,3,37454,36366,1088,2,81953,82322,82892,213,897,916,186,808,805,3904,15525,16781,19191
20105,KS,"Lincoln County, KS",1743,1693,50,2,1691,1653,38,2,1693,1653,40,2,2948,2907,2899,10,28,28,11,49,50,92,538,916,508
20107,KS,"Linn County, KS",4358,4046,312,7,4352,4162,190,4,4373,4203,170,3,9586,9730,9796,27,100,101,28,152,153,433,2653,2361,1405
20109,KS,"Logan County, KS",1616,1578,38,2,1622,1595,27,1,1607,1577,30,1,2743,2710,2705,9,33,33,10,43,44,142,588,776,386
20111,KS,"Lyon County, KS",16709,15934,775,4,16958,16462,496,2,17028,16598,430,2,32107,31987,31898,84,319,328,92,366,377,2246,6103,5794,5145
20113,KS,"McPherson County, KS",17256,16672,584,3,17205,16831,374,2,17375,17041,334,1,30180,30137,30012,72,284,294,99,444,438,1689,5298,7342,6053
20115,KS,"Marion County, KS",5983,5743,240,4,6010,5861,149,2,5963,5818,145,2,11778,11756,11868,30,125,126,38,163,168,664,2441,2777,2237
20117,KS,"Marshall County, KS",5512,5345,167,3,5432,5323,109,2,5315,5209,106,2,10026,10010,9982,28,111,111,31,145,147,594,2719,2307,1298
20119,KS,"Meade County, KS",2160,2101,59,2,2181,2132,49,2,2116,2076,40,1,4054,3989,3897,13,57,57,13,69,73,406,602,1026,586
20121,KS,"Miami County, KS",17676,16797,879,5,17842,17308,534,3,18037,17576,461,2,34232,34665,34867,83,324,329,74,355,346,1085,6932,7472,7560
20123,KS,"Mitchell County, KS",3444,3354,90,2,3435,3365,70,2,3359,3293,66,2,5772,5757,5738,13,66,66,20,96,101,202,1004,1689,1012
20125,KS,"Montgomery County, KS",14957,13863,1094,7,14724,14136,588,4,14631,14181,450,3,31393,31202,30996,85,354,358,106,491,488,2148,6889,8105,4417
20127,KS,"Morris County, KS",3094,2973,121,3,3080,3006,74,2,3037,2967,70,2,5367,5362,5349,12,44,44,20,98,96,284,1394,1270,996
20129,KS,"Morton County, KS",1135,1101,34,3,1137,1107,30,2,1121,1091,30,2,2697,2669,2599,8,32,33,10,45,46,222,651,626,312
20131,KS,"Nemaha County, KS",5611,5454,157,2,5577,5475,102,1,5611,5508,103,1,10265,10216,10115,40,143,147,28,187,185,432,2458,1848,1853
20133,KS,"Neosho County, KS",6257,5860,397,6,6118,5852,266,4,6036,5819,217,3,15905,15779,15606,43,179,181,49,242,241,948,3221,4221,2165
20135,KS,"Ness County, KS",1356,1310,46,3,1317,1287,30,2,1327,1298,29,2,2667,2651,2645,6,31,31,9,63,64,161,626,689,415
20137,KS,"Norton County, KS",2658,2590,68,2,2669,2620,49,1,2617,2567,50,1,5453,5369,5301,16,60,60,13,87,88,390,1231,1445,931
20139,KS,"Osage County, KS",7997,7590,407,5,8052,7807,245,3,8033,7808,225,2,15746,15746,15654,47,171,174,57,289,295,905,4276,3431,2341
20141,KS,"Osborne County, KS",1983,1929,54,2,1967,1930,37,1,1904,1865,39,2,3497,3485,3490,12,44,44,17,63,61,150,871,978,547
20143,KS,"Ottawa County, KS",2988,2865,123,4,2969,2884,85,2,3012,2936,76,2,5728,5834,5795,11,54,54,15,81,83,203,1341,1636,858
20145,KS,"Pawnee County, KS",2866,2763,103,3,2829,2764,65,2,2706,2641,65,2,6261,6246,6179,13,65,65,16,97,97,453,1613,1871,953
20147,KS,"Phillips County, KS",2656,2568,88,3,2638,2580,58,2,2656,2597,59,2,4977,4845,4809,18,51,52,17,80,83,321,1213,1237,757
20149,KS,"Pottawatomie County, KS",12201,11695,506,4,12297,11979,318,2,12519,12216,303,2,25411,25860,26273,85,352,361,50,208,204,683,4633,4708,5814
20151,KS,"Pratt County, KS",4948,4773,175,3,4903,4790,113,2,4903,4798,105,2,9148,9180,9067,26,102,104,36,147,145,430,1628,2023,1928
20153,KS,"Rawlins County, KS",1552,1513,39,2,1626,1600,26,1,1529,1501,28,1,2565,2559,2528,8,30,30,3,40,40,85,517,865,406
20155,KS,"Reno County, KS",29913,28294,1619,5,29721,28747,974,3,29232,28406,826,2,61887,61510,61516,170,623,636,184,880,861,3724,12859,17286,8841
20157,KS,"Republic County, KS",2326,2251,75,3,2358,2302,56,2,2383,2333,50,2,4677,4682,4642,12,47,47,16,85,84,161,1053,1263,875
20159,KS,"Rice County, KS",5111,4900,211,4,5301,5168,133,2,5335,5212,123,2,9385,9406,9407,26,101,101,25,127,129,433,1892,2390,1369
20161,KS,"Riley County, KS",33749,32110,1639,4,33889,32914,975,2,34620,33691,929,2,72013,71849,71108,174,697,710,104,418,422,1447,5987,11853,17926
20163,KS,"Rooks County, KS",2515,2417,98,3,2454,2392,62,2,2408,2345,63,2,4895,4870,4813,14,45,45,18,66,69,336,1171,1293,729
20165,KS,"Rush County, KS",1581,1509,72,4,1585,1546,39,2,1616,1580,36,2,2938,2925,2927,8,28,28,12,72,74,157,664,825,423
20167,KS,"Russell County, KS",3326,3189,137,4,3351,3267,84,2,3295,3220,75,2,6670,6677,6639,18,65,65,23,151,158,327,1353,2028,1019
20169,KS,"Saline County, KS",29663,28057,1606,5,29473,28570,903,3,30214,29483,731,2,54253,53899,53596,151,607,617,134,661,645,2447,10860,13234,10226
20171,KS,"Scott County, KS",2839,2771,68,2,2841,2795,46,1,2737,2687,50,1,5138,5121,5014,9,64,64,7,63,62,534,926,1078,799
20173,KS,"Sedgwick County, KS",259283,236571,22712,8,255879,244066,11813,4,255813,247806,8007,3,524786,524481,525525,1713,6512,6649,1236,5875,5938,35387,89149,108564,105634
20175,KS,"Seward County, KS",9852,9439,413,4,9900,9617,283,2,9811,9560,251,2,21854,21747,21358,90,357,370,31,170,168,3817,4006,3621,1461
20177,KS,"Shawnee County, KS",91649,86325,5324,5,91820,88910,2910,3,91886,89363,2523,2,178698,178367,177480,473,1991,2033,493,2354,2371,8279,36966,37209,39301
20179,KS,"Sheridan County, KS",1473,1439,34,2,1465,1437,28,1,1455,1427,28,1,2451,2452,2425,9,25,25,7,52,54,71,578,668,390
20181,KS,"Sherman County, KS",2885,2790,95,3,2863,2789,74,2,2790,2726,64,2,5895,5911,5830,11,59,60,8,68,72,366,1162,1426,805
20183,KS,"Smith County, KS",2001,1949,52,2,2010,1974,36,1,1953,1913,40,2,3552,3555,3533,3,21,21,9,56,61,101,1036,934,563
20185,KS,"Stafford County, KS",2033,1960,73,3,1971,1925,46,2,1914,1869,45,2,4055,4008,3993,8,53,53,21,71,71,217,862,972,735
20187,KS,"Stanton County, KS",1082,1058,24,2,1099,1077,22,2,1099,1078,21,1,2083,2041,1963,7,20,20,4,25,28,239,495,368,194
20189,KS,"Stevens County, KS",2818,2742,76,2,2877,2815,62,2,2964,2906,58,2,5246,5299,5175,20,72,72,13,59,60,859,883,1143,402
20191,KS,"Sumner County, KS",10915,10021,894,8,10770,10321,449,4,10777,10456,321,3,22342,22386,22473,60,249,253,66,321,315,1015,5328,5023,3880
20193,KS,"Thomas County, KS",4256,4140,116,2,4256,4174,82,1,4247,4165,82,1,7933,7942,7893,27,116,117,17,84,85,398,1164,2248,1213
20195,KS,"Trego County, KS",1456,1406,50,3,1423,1392,31,2,1358,1325,33,2,2805,2792,2752,8,35,35,9,51,50,114,633,893,511
20197,KS,"Wabaunsee County, KS",3698,3546,152,4,3735,3641,94,2,3737,3645,92,2,6885,6969,7019,22,74,74,11,71,70,169,1758,1645,1147
20199,KS,"Wallace County, KS",840,823,17,2,889,873,16,1,852,835,17,2,1517,1514,1488,5,24,24,4,22,24,46,300,421,303
20201,KS,"Washington County, KS",3080,3007,73,2,3074,3019,55,1,3002,2943,59,2,5532,5526,5501,16,68,68,15,79,80,244,1589,1160,865
20203,KS,"Wichita County, KS",1249,1225,24,1,1179,1156,23,2,1146,1123,23,2,2149,2081,2064,10,36,36,3,39,41,208,490,574,280
20205,KS,"Wilson County, KS",3929,3624,305,7,3826,3669,157,4,3723,3606,117,3,8576,8537,8622,24,96,97,29,125,127,562,2250,2100,1104
20207,KS,"Woodson County, KS",1571,1477,94,6,1527,1473,54,3,1539,1485,54,3,3091,3076,3109,7,28,29,18,62,62,221,905,748,481
20209,KS,"Wyandotte County, KS",78193,72029,6164,7,77936,74238,3698,4,78206,75487,2719,3,168904,167290,165746,587,2463,2521,449,1735,1741,20121,34494,31632,20584
21000,KY,Kentucky,2017001,1886072,130929,6,2027165,1937537,89628,4,2048066,1968121,79945,3,4507445,4506589,4512310,12580,51453,52496,12816,58285,60854,376963,1000507,891024,785070
21001,KY,"Adair County, KY",7020,6527,493,7,7231,6889,342,4,7195,6868,327,4,18880,18953,19067,50,200,203,92,292,304,1866,4962,3382,2386
21003,KY,"Allen County, KY",8664,8195,469,5,8859,8516,343,3,8963,8618,345,3,20573,20828,21275,57,254,258,70,276,287,1999,5909,3819,2471
21005,KY,"Anderson County, KY",11765,11067,698,5,11841,11392,449,3,11994,11615,379,3,23870,24043,24224,57,248,251,71,294,305,1442,5565,5141,4115
21007,KY,"Ballard County, KY",3324,3112,212,6,3426,3261,165,4,3489,3320,169,4,7712,7690,7650,8,63,60,24,106,130,599,2178,1880,894
21009,KY,"Barren County, KY",18074,16742,1332,7,17862,16963,899,5,17883,17152,731,4,44502,44599,44854,108,484,497,129,635,665,4803,13133,7314,5234
21011,KY,"Bath County, KY",4538,4170,368,8,4629,4377,252,5,4761,4515,246,5,12716,12774,12829,39,169,171,56,204,202,1512,3695,1951,1250
21013,KY,"Bell County, KY",8185,7563,622,7,8149,7705,444,5,8147,7737,410,5,23984,23765,23568,62,283,296,86,508,528,4264,7270,4027,1717
21015,KY,"Boone County, KY",70586,66872,3714,5,71333,68785,2548,3,72572,70299,2273,3,136465,137760,139093,414,1689,1729,263,1121,1167,6052,25378,27190,30141
21017,KY,"Bourbon County, KY",9568,9020,548,5,9637,9281,356,3,9633,9296,337,3,20290,20218,20093,43,198,203,55,307,316,1980,4787,3955,3215
21019,KY,"Boyd County, KY",17466,16043,1423,8,17125,16123,1002,5,17205,16323,882,5,48197,47767,48110,108,528,544,179,778,815,4064,11307,12094,7129
21021,KY,"Boyle County, KY",12563,11666,897,7,12613,12017,596,4,12774,12273,501,3,30753,30649,30904,72,299,303,77,421,442,2098,7175,5653,5437
21023,KY,"Bracken County, KY",3715,3490,225,6,3764,3596,168,4,3810,3648,162,4,8402,8446,8452,25,95,96,18,116,123,642,2707,1669,748
21025,KY,"Breathitt County, KY",3252,2926,326,10,3233,2972,261,8,3206,2971,235,7,13694,13527,13351,31,149,150,52,247,262,2203,3752,2171,1648
21027,KY,"Breckinridge County, KY",7819,7264,555,7,8004,7610,394,4,7975,7611,364,4,20443,20652,20943,58,256,254,66,319,342,1952,6224,3874,1987
21029,KY,"Bullitt County, KY",42155,39529,2626,6,42592,40697,1895,4,43128,41390,1738,4,82355,83076,83836,211,790,806,193,830,869,6060,23540,18779,9288
21031,KY,"Butler County, KY",4858,4525,333,6,4927,4710,217,4,4996,4791,205,4,12318,12279,12295,29,138,138,49,210,217,1664,3985,1832,1199
21033,KY,"Caldwell County, KY",5584,5250,334,6,5922,5685,237,4,6119,5911,208,3,12634,12644,12570,27,146,156,43,200,205,1160,3630,2560,1520
21035,KY,"Calloway County, KY",17775,16698,1077,6,17499,16747,752,4,17426,16734,692,4,37145,37489,37685,78,346,349,107,480,516,2275,7286,6326,7342
21037,KY,"Campbell County, KY",49567,46890,2677,5,50157,48244,1913,3,50998,49302,1696,3,93129,92856,93300,247,976,994,226,948,999,4486,17108,17750,24844
21039,KY,"Carlisle County, KY",2162,2064,98,4,2261,2178,83,3,2263,2179,84,3,4806,4760,4720,14,54,54,25,93,99,488,1582,833,416
21041,KY,"Carroll County, KY",5293,4988,305,5,5380,5172,208,3,5715,5535,180,3,10836,10884,10938,42,161,165,35,151,159,1371,3010,2272,471
21043,KY,"Carter County, KY",9524,8630,894,9,9581,8886,695,7,9695,9012,683,7,26607,26432,26395,72,289,293,68,412,425,3752,7312,4880,2361
21045,KY,"Casey County, KY",6655,6251,404,6,6740,6475,265,3,6682,6432,250,3,15924,15951,15920,52,177,177,51,252,255,2813,4455,2470,1272
21047,KY,"Christian County, KY",24464,22560,1904,7,24568,23211,1357,5,24874,23683,1191,4,72768,73221,73037,355,1447,1477,180,802,850,5672,12978,14874,7517
21049,KY,"Clark County, KY",16960,15879,1081,6,17017,16307,710,4,17293,16679,614,3,37037,36925,37061,99,406,411,114,468,517,2787,9425,8475,5189
21051,KY,"Clay County, KY",5168,4739,429,8,5149,4821,328,6,5083,4797,286,5,20310,20184,19913,58,230,232,66,346,368,4658,5566,2800,1691
21053,KY,"Clinton County, KY",3951,3755,196,5,3939,3771,168,4,3642,3466,176,4,9232,9288,9123,30,114,117,38,173,174,1466,2572,1730,927
21055,KY,"Crittenden County, KY",3674,3475,199,5,3800,3643,157,4,3832,3674,158,4,9002,8939,8981,28,94,95,32,146,157,906,2799,1834,824
21057,KY,"Cumberland County, KY",3254,3099,155,4,3290,3179,111,3,3394,3286,108,3,5860,5892,5946,15,70,70,30,115,123,886,1991,889,585
21059,KY,"Daviess County, KY",45856,43139,2717,5,46095,44211,1884,4,46047,44268,1779,3,103391,103140,103222,274,1211,1241,279,1267,1326,6247,23268,22110,17217
21061,KY,"Edmonson County, KY",4590,4245,345,7,4637,4410,227,4,4738,4510,228,4,12153,12213,12269,26,107,107,46,171,179,1687,4047,2201,897
21063,KY,"Elliott County, KY",1951,1760,191,9,1876,1728,148,7,1893,1741,152,8,7333,7375,7293,12,53,52,20,95,110,1369,2545,1096,492
21065,KY,"Estill County, KY",5138,4759,379,7,5089,4840,249,4,5189,4940,249,4,14161,14090,14044,38,128,131,52,235,258,2597,4329,2095,1071
21067,KY,"Fayette County, KY",171805,162169,9636,5,172829,166438,6391,3,175935,170528,5407,3,322613,320473,320347,883,3631,3710,710,2933,3007,15977,39476,58334,95430
21069,KY,"Fleming County, KY",6109,5672,437,7,6056,5775,281,4,6085,5816,269,4,15098,15268,15288,49,194,198,45,205,210,1896,4094,2565,1591
21071,KY,"Floyd County, KY",10646,9702,944,8,10749,10040,709,6,10907,10273,634,5,35804,35300,34978,99,381,387,157,685,701,5794,9876,6474,3197
21073,KY,"Franklin County, KY",24731,23155,1576,6,24873,23839,1034,4,25148,24302,846,3,51589,51683,51607,143,530,546,163,706,726,3404,10924,11068,10703
21075,KY,"Fulton County, KY",1984,1856,128,6,2074,1971,103,5,2116,2021,95,4,6512,6513,6382,15,61,61,21,114,125,909,1775,1237,624
21077,KY,"Gallatin County, KY",3950,3718,232,5,3991,3827,164,4,4030,3886,144,3,8672,8766,8763,28,102,103,32,117,121,874,2885,1453,606
21079,KY,"Garrard County, KY",7516,7054,462,6,7601,7277,324,4,7910,7608,302,3,16965,17385,17589,44,159,163,45,236,242,1779,4669,3288,2504
21081,KY,"Grant County, KY",11595,10795,800,6,11604,11112,492,4,11765,11324,441,3,25014,25302,25502,98,352,361,80,299,307,1868,7209,4454,2389
21083,KY,"Graves County, KY",15559,14661,898,5,15835,15167,668,4,15602,14897,705,4,36527,36634,36412,93,439,450,141,576,590,2607,10073,7626,4449
21085,KY,"Grayson County, KY",10643,9835,808,7,10461,9908,553,5,10465,9988,477,4,26454,26582,26631,87,341,347,71,418,441,3001,8145,4705,2040
21087,KY,"Green County, KY",5147,4876,271,5,5139,4957,182,3,5078,4890,188,3,11130,11308,11365,26,112,113,31,174,179,1535,3267,2085,1113
21089,KY,"Greenup County, KY",13148,12003,1145,8,12905,12066,839,6,12952,12201,751,5,35887,35682,35403,80,295,300,137,547,581,2516,9361,9443,4303
21091,KY,"Hancock County, KY",3812,3585,227,6,3831,3673,158,4,3840,3678,162,4,9105,9083,9021,19,89,89,20,123,131,884,2610,1683,936
21093,KY,"Hardin County, KY",47665,44346,3319,7,46903,44787,2116,4,47147,45219,1928,4,110816,111766,111862,353,1398,1432,263,1318,1367,5821,22325,28325,16486
21095,KY,"Harlan County, KY",6509,5761,748,11,6417,5909,508,7,6386,5986,400,6,26752,26177,25662,85,289,295,108,575,600,4738,6741,5569,1793
21097,KY,"Harrison County, KY",8673,8152,521,6,8737,8417,320,3,8829,8541,288,3,18718,18964,19103,48,222,227,51,277,287,1946,5260,3520,2268
21099,KY,"Hart County, KY",7638,7153,485,6,7649,7329,320,4,7683,7381,302,3,19289,19485,19600,62,249,251,49,274,280,2829,5507,3153,1357
21101,KY,"Henderson County, KY",20663,19417,1246,6,20672,19795,877,4,20759,19976,783,3,44668,44417,44046,119,495,498,139,632,664,3609,11906,10162,5640
21103,KY,"Henry County, KY",8023,7570,453,5,8115,7804,311,3,8161,7869,292,3,15697,15704,15771,50,192,194,48,206,216,1682,4472,3070,1481
21105,KY,"Hickman County, KY",1718,1629,89,5,1723,1651,72,4,1658,1587,71,4,4530,4430,4422,7,38,39,10,91,87,366,1264,821,789
21107,KY,"Hopkins County, KY",18023,16718,1305,7,18012,17136,876,4,18259,17464,795,4,45366,45096,44812,103,494,507,188,744,768,3896,12640,9908,5210
21109,KY,"Jackson County, KY",4039,3699,340,8,4061,3820,241,5,4142,3908,234,5,12962,12987,12973,40,150,150,48,217,232,2628,4043,1666,834
21111,KY,"Jefferson County, KY",389491,363423,26068,6,392078,374258,17820,4,395552,380623,14929,3,782783,777378,773399,2341,9313,9534,2264,9751,10032,47255,142247,161700,189038
21113,KY,"Jessamine County, KY",25931,24508,1423,5,26163,25170,993,3,26635,25773,862,3,53016,53609,54254,153,608,613,126,580,600,3626,11166,9944,10420
21115,KY,"Johnson County, KY",6584,6032,552,8,6601,6149,452,6,6646,6254,392,5,22644,22539,22244,58,225,229,77,397,417,2716,6345,4387,2585
21117,KY,"Kenton County, KY",86016,81164,4852,5,86899,83485,3414,3,88273,85346,2927,3,169246,169734,170313,561,2156,2202,404,1651,1764,9698,31465,32799,40749
21119,KY,"Knott County, KY",4288,3932,356,8,4262,3977,285,6,4272,4012,260,6,14163,14033,13874,25,117,117,64,236,261,2981,2975,2504,1616
21121,KY,"Knox County, KY",9876,9084,792,8,9905,9323,582,5,9930,9402,528,5,30183,30019,29791,103,393,396,116,504,529,4887,7944,4437,3117
21123,KY,"Larue County, KY",5842,5429,413,7,5777,5508,269,4,5774,5520,254,4,14877,15024,15163,38,158,160,48,203,216,2017,3550,3168,1776
21125,KY,"Laurel County, KY",24920,23234,1686,6,24919,23843,1076,4,25098,24053,1045,4,62728,62592,62885,181,697,709,194,921,941,7501,16940,11785,6613
21127,KY,"Lawrence County, KY",5206,4785,421,8,5328,5004,324,6,5615,5316,299,5,16303,16268,16109,40,168,168,46,253,263,2673,4827,2458,1378
21129,KY,"Lee County, KY",2043,1904,139,6,2017,1910,107,5,2081,1968,113,5,7372,7454,7261,18,69,68,29,149,152,1441,2176,1286,419
21131,KY,"Leslie County, KY",2579,2306,273,10,2523,2334,189,7,2518,2353,165,6,10471,10298,10093,27,109,108,32,177,195,1219,3395,2113,679
21133,KY,"Letcher County, KY",6064,5465,599,9,6007,5582,425,7,5916,5555,361,6,21465,21245,20893,48,194,196,81,390,417,3587,5537,4842,1600
21135,KY,"Lewis County, KY",4654,4222,432,9,4646,4312,334,7,4586,4257,329,7,13082,13006,12954,41,159,163,30,209,222,2091,4012,2246,808
21137,KY,"Lincoln County, KY",9213,8498,715,7,9239,8751,488,5,9376,8932,444,4,24249,24227,24360,68,309,312,89,426,430,2962,7378,4141,2304
21139,KY,"Livingston County, KY",3500,3241,259,7,3602,3395,207,5,3650,3476,174,4,8873,8984,8963,23,89,93,30,181,186,894,2742,1982,957
21141,KY,"Logan County, KY",12102,11447,655,5,12249,11805,444,3,12390,11958,432,3,27515,27815,27877,110,369,378,99,375,396,2332,8174,5023,3159
21143,KY,"Lyon County, KY",3054,2896,158,5,3104,2972,132,4,3207,3072,135,4,8678,8436,9101,14,50,52,27,140,144,738,3074,2060,982
21145,KY,"McCracken County, KY",28744,26753,1991,6,29455,28048,1407,4,29928,28728,1200,4,67911,67612,67490,167,685,699,184,947,1008,3582,15235,15855,12632
21147,KY,"McCreary County, KY",4823,4483,340,7,4821,4557,264,5,4719,4475,244,5,16857,16681,16701,39,192,191,49,264,271,2602,4903,3478,828
21149,KY,"McLean County, KY",3964,3744,220,5,4004,3841,163,4,3995,3819,176,4,9134,9127,9105,21,95,95,25,146,155,640,2494,2163,1113
21151,KY,"Madison County, KY",45840,43132,2708,5,46238,44424,1814,3,46866,45179,1687,3,92983,93473,95187,248,1028,1060,241,1035,1081,5871,15409,16557,18965
21153,KY,"Magoffin County, KY",3181,2684,497,15,3191,2823,368,11,3186,2850,336,10,11604,11476,11357,34,133,132,43,202,206,2313,3128,1946,908
21155,KY,"Marion County, KY",9217,8510,707,7,9255,8875,380,4,9353,9040,313,3,19588,19758,19775,51,215,219,59,254,265,1961,5879,3593,1876
21157,KY,"Marshall County, KY",14798,13908,890,6,14389,13755,634,4,14588,13995,593,4,31685,31820,31777,64,297,304,107,490,510,1891,8201,8012,4932
21159,KY,"Martin County, KY",2476,2195,281,11,2331,2131,200,8,2219,2056,163,7,11249,11157,11095,27,111,112,36,166,179,2189,2968,2188,984
21161,KY,"Mason County, KY",6854,6321,533,7,6727,6374,353,5,6590,6273,317,4,17130,16965,16930,48,203,206,43,252,265,1646,3662,3907,2624
21163,KY,"Meade County, KY",11750,10933,817,7,11629,11046,583,5,11648,11133,515,4,30030,30132,30001,73,252,258,68,332,345,2208,8187,6668,3581
21165,KY,"Menifee County, KY",2251,2055,196,8,2307,2158,149,6,2394,2259,135,5,6135,6209,6250,26,74,74,19,104,121,1011,1867,968,478
21167,KY,"Mercer County, KY",9864,9163,701,7,9895,9468,427,4,10088,9714,374,3,22652,22872,22902,54,228,234,57,332,349,1858,5452,5198,3141
21169,KY,"Metcalfe County, KY",3983,3678,305,7,3943,3741,202,5,3921,3745,176,4,10286,10363,10370,26,113,114,38,179,176,1316,3068,1762,981
21171,KY,"Monroe County, KY",4558,4319,239,5,4627,4453,174,3,4618,4465,153,3,11316,11269,11355,27,132,137,30,172,185,1502,3219,1922,1153
21173,KY,"Montgomery County, KY",11327,10445,882,7,11545,10969,576,5,12003,11466,537,4,28104,28231,28367,78,327,335,79,386,419,2788,7926,5200,3195
21175,KY,"Morgan County, KY",4395,4104,291,6,4272,4041,231,5,4142,3924,218,5,13729,13682,14120,31,127,127,37,172,183,2351,4052,2218,1560
21177,KY,"Muhlenberg County, KY",9916,9076,840,8,9796,9189,607,6,9853,9293,560,5,30886,30072,30455,71,324,328,89,451,483,3670,9426,6310,2635
21179,KY,"Nelson County, KY",22699,21151,1548,6,23070,22114,956,4,23678,22784,894,3,46784,47149,47392,110,526,544,111,565,592,2507,11599,11093,6634
21181,KY,"Nicholas County, KY",3272,3050,222,6,3305,3171,134,4,3296,3162,134,4,7540,7750,7805,23,92,92,20,101,111,979,2394,1326,477
21183,KY,"Ohio County, KY",9274,8621,653,7,9019,8550,469,5,9108,8662,446,4,23746,23730,23527,66,260,263,67,336,355,3061,6444,4487,2386
21185,KY,"Oldham County, KY",32440,30902,1538,4,32956,31833,1123,3,33401,32311,1090,3,67692,68232,69431,125,527,541,113,495,510,2728,8888,13356,19946
21187,KY,"Owen County, KY",5086,4768,318,6,5110,4903,207,4,5230,5054,176,3,11304,11307,11290,20,94,98,30,162,168,1332,3218,1814,1408
21189,KY,"Owsley County, KY",1079,978,101,9,1056,985,71,6,1075,1001,74,6,4031,3967,3929,12,48,50,21,101,103,939,1236,466,344
21191,KY,"Pendleton County, KY",6762,6417,345,5,6880,6610,270,3,6969,6724,245,3,14652,14611,14676,35,163,165,43,206,207,1667,4320,2460,1603
21193,KY,"Perry County, KY",8134,7428,706,8,7978,7512,466,5,7991,7590,401,5,28360,27906,27361,70,310,317,127,552,589,4388,6460,6178,2772
21195,KY,"Pike County, KY",19102,17543,1559,8,19010,17875,1135,6,18976,17998,978,5,58443,57362,56286,124,538,544,216,1077,1086,8852,16537,9937,6592
21197,KY,"Powell County, KY",5045,4681,364,7,5113,4880,233,4,5265,5048,217,4,13095,13110,13083,36,157,159,53,200,211,1599,3852,1969,1467
21199,KY,"Pulaski County, KY",25726,23880,1846,7,25699,24496,1203,4,25396,24245,1151,4,65104,65561,65795,171,693,713,211,1004,1067,7540,15602,14528,7805
21201,KY,"Robertson County, KY",787,741,46,5,800,768,32,4,820,779,41,5,2181,2250,2229,3,18,18,12,44,48,236,621,474,212
21203,KY,"Rockcastle County, KY",6372,5915,457,7,6396,6093,303,4,6492,6193,299,4,16064,16151,16242,34,155,157,44,259,301,2250,5006,2848,1396
21205,KY,"Rowan County, KY",9967,9241,726,7,9966,9471,495,5,10223,9755,468,4,24716,24586,24388,56,262,268,62,287,313,1880,4949,3813,3706
21207,KY,"Russell County, KY",6068,5578,490,8,6089,5773,316,5,6263,5956,307,4,17995,18195,18178,49,192,188,73,299,321,2237,4630,3481,1994
21209,KY,"Scott County, KY",29874,28053,1821,6,29826,28792,1034,3,30403,29484,919,3,57520,58312,59099,171,697,713,105,533,560,2370,11159,12405,10972
21211,KY,"Shelby County, KY",25409,24059,1350,5,25729,24791,938,3,25955,25070,885,3,48243,48580,48886,134,555,567,113,499,518,4232,9421,9687,9419
21213,KY,"Simpson County, KY",8517,7913,604,7,8774,8424,350,4,8799,8498,301,3,19626,19716,19949,62,224,226,59,268,273,1364,5773,4037,1789
21215,KY,"Spencer County, KY",10342,9761,581,5,10481,10056,425,4,10626,10209,417,3,19510,19895,20204,38,189,193,37,198,209,1057,5136,4216,3001
21217,KY,"Taylor County, KY",12972,12214,758,5,12302,11843,459,3,12268,11816,452,3,26000,26158,26407,74,322,334,100,412,431,2187,6220,4877,3702
21219,KY,"Todd County, KY",5392,5139,253,4,5525,5335,190,3,5712,5529,183,3,12289,12321,12404,41,174,175,30,157,171,1660,3163,1969,1174
21221,KY,"Trigg County, KY",5966,5559,407,6,6012,5721,291,4,6078,5805,273,4,14080,14202,14332,35,154,158,48,233,244,1108,3244,3517,2098
21223,KY,"Trimble County, KY",3782,3531,251,6,3815,3639,176,4,3845,3678,167,4,8461,8553,8539,23,90,90,27,119,139,975,2757,1417,890
21225,KY,"Union County, KY",5923,5554,369,6,5927,5676,251,4,5851,5601,250,4,13665,13166,12961,36,148,148,35,218,227,799,4243,3178,926
21227,KY,"Warren County, KY",63448,59374,4074,6,64258,61659,2599,4,65603,63266,2337,3,135013,137148,139843,406,1746,1788,309,1320,1387,9887,21991,23114,26288
21229,KY,"Washington County, KY",6080,5706,374,6,6148,5922,226,3,6148,5936,212,3,12042,12091,12061,31,121,126,29,170,171,1102,3429,2023,1716
21231,KY,"Wayne County, KY",7344,6879,465,6,7322,6967,355,4,7078,6727,351,5,19542,19569,19681,50,219,222,65,310,327,3204,5467,3144,2233
21233,KY,"Webster County, KY",5410,5070,340,6,5353,5129,224,4,5235,5030,205,3,13017,12857,12726,40,154,156,28,211,213,1310,4194,2463,886
21235,KY,"Whitley County, KY",13792,12834,958,6,13820,13159,661,4,13904,13295,609,4,36695,36699,36873,123,517,527,131,601,622,4053,9072,5476,4554
21237,KY,"Wolfe County, KY",2079,1924,155,7,2214,2088,126,5,2248,2123,125,5,6556,6491,6400,19,78,79,26,140,153,1549,1520,1177,298
21239,KY,"Woodford County, KY",14849,14124,725,4,15015,14535,480,3,15041,14596,445,3,26902,27090,27062,59,246,253,62,296,305,1515,4947,4739,7358
22000,LA,Louisiana,2064942,1887347,177595,8,2073572,1958087,115485,5,2088217,2011867,76350,3,4651664,4627098,4590241,13555,57123,57152,14831,56590,55995,431595,1036204,865973,800083
22001,LA,"Acadia Parish, LA",23344,21547,1797,7,23627,22420,1207,5,23943,23069,874,3,57472,57262,56744,176,813,814,205,898,898,7546,16454,9098,5216
22003,LA,"Allen Parish, LA",8401,7593,808,9,8124,7662,462,5,8128,7789,339,4,22684,22604,22320,52,291,291,81,369,369,3285,7038,3951,1971
22005,LA,"Ascension Parish, LA",64382,59859,4523,7,65611,62804,2807,4,67286,65300,1986,3,126966,128502,130458,404,1641,1646,267,1001,983,9235,23770,25188,23447
22007,LA,"Assumption Parish, LA",8781,7854,927,10,8898,8266,632,7,8848,8442,406,4,20957,20726,20604,68,240,240,85,264,253,3471,6465,3385,1613
22009,LA,"Avoyelles Parish, LA",14944,13691,1253,8,14756,13958,798,5,14428,13827,601,4,39638,39265,38751,129,472,474,144,608,594,6410,9771,7808,3367
22011,LA,"Beauregard Parish, LA",14406,13389,1017,7,14607,13982,625,4,14859,14360,499,3,36600,36619,36570,108,492,495,107,490,479,3043,9491,7351,4452
22013,LA,"Bienville Parish, LA",5381,4946,435,8,5240,4934,306,5,5248,5030,218,4,12918,12800,12641,44,159,159,69,260,255,1245,4427,2406,1154
22015,LA,"Bossier Parish, LA",56839,53071,3768,6,57317,55027,2290,4,58245,56495,1750,3,128717,129402,129276,386,1611,1613,292,1332,1329,8217,25117,29114,22835
22017,LA,"Caddo Parish, LA",101573,92035,9538,9,101828,95448,6380,6,102126,97955,4171,4,236928,232741,229025,696,2902,2904,928,3540,3490,21893,52222,49585,39073
22019,LA,"Calcasieu Parish, LA",97450,88234,9216,9,95386,89951,5435,5,92883,89629,3254,3,216465,205095,202418,659,2650,2649,602,2633,2632,16659,48394,42270,33514
22021,LA,"Caldwell Parish, LA",3652,3369,283,7,3706,3528,178,4,3694,3553,141,3,9611,9593,9554,26,124,124,37,156,151,1560,3185,1166,817
22023,LA,"Cameron Parish, LA",3509,3296,213,6,3486,3359,127,3,3448,3351,97,2,5623,5099,4902,14,82,82,18,67,71,548,1453,1268,676
22025,LA,"Catahoula Parish, LA",3452,3193,259,7,3489,3303,186,5,3452,3310,142,4,8841,8712,8566,17,87,87,31,164,170,1761,2456,1262,1003
22027,LA,"Claiborne Parish, LA",5465,5082,383,7,5476,5200,276,5,5448,5240,208,3,14103,13990,13744,23,124,123,64,248,248,2369,4935,2114,1311
22029,LA,"Concordia Parish, LA",6901,6304,597,8,6923,6506,417,6,7007,6683,324,4,18568,18373,18116,50,227,226,70,310,304,2388,5470,2856,1963
22031,LA,"De Soto Parish, LA",10702,9889,813,7,10790,10248,542,5,10953,10534,419,3,26838,26934,26853,68,317,319,98,360,359,3211,7636,4827,2645
22033,LA,"East Baton Rouge Parish, LA",226294,207840,18454,8,230296,218082,12214,5,234834,226718,8116,3,455886,453653,450544,1300,5554,5551,1354,4808,4720,27668,74591,78572,108548
22035,LA,"East Carroll Parish, LA",1813,1587,226,12,1754,1580,174,9,1641,1512,129,7,7397,7242,6990,18,86,86,25,108,108,1708,1769,977,506
22037,LA,"East Feliciana Parish, LA",7577,7041,536,7,7754,7393,361,4,7933,7683,250,3,19450,19319,19135,45,177,177,100,317,316,2728,5871,3634,2315
22039,LA,"Evangeline Parish, LA",11956,10981,975,8,12030,11357,673,5,12048,11554,494,4,32304,32190,31986,108,441,441,107,518,512,5371,8465,4904,2695
22041,LA,"Franklin Parish, LA",7325,6695,630,8,7442,6997,445,6,7448,7092,356,4,19712,19593,19308,56,235,235,66,348,338,3100,5483,2831,1983
22043,LA,"Grant Parish, LA",8128,7566,562,6,8228,7883,345,4,8365,8076,289,3,22135,22212,22000,61,264,262,59,289,288,2992,6646,4455,1833
22045,LA,"Iberia Parish, LA",27528,24786,2742,10,27762,25831,1931,7,27685,26522,1163,4,70054,69298,68327,181,903,904,256,919,925,7622,20129,11797,6681
22047,LA,"Iberville Parish, LA",13657,12243,1414,10,13818,12833,985,7,13988,13372,616,4,30058,29713,29506,62,310,310,128,462,459,4384,8640,5317,3403
22049,LA,"Jackson Parish, LA",6730,6349,381,5,6799,6534,265,3,6942,6721,221,3,14997,14922,14839,43,161,160,66,246,242,1803,4783,2876,1336
22051,LA,"Jefferson Parish, LA",209739,189702,20037,9,209224,196663,12561,6,210587,203079,7508,3,439712,433929,425884,1284,5286,5283,1551,5137,5004,40816,90304,89353,88541
22053,LA,"Jefferson Davis Parish, LA",12745,11731,1014,8,12519,11899,620,5,12400,11967,433,3,32210,32413,32026,96,439,440,90,468,473,3677,9310,5006,3559
22055,LA,"Lafayette Parish, LA",114314,105843,8471,7,115628,110275,5353,4,116728,113046,3682,3,242148,244922,247866,707,3278,3277,529,2277,2292,17357,48271,41591,55040
22057,LA,"Lafourche Parish, LA",41217,38396,2821,6,40795,38860,1935,4,40562,39183,1379,3,97434,97537,95870,253,1119,1117,340,1092,1079,12753,27700,14798,11596
22059,LA,"LaSalle Parish, LA",6840,6492,348,5,6736,6507,229,3,6778,6599,179,2,14822,14793,14729,31,148,149,39,227,218,1875,3917,2434,1680
22061,LA,"Lincoln Parish, LA",21017,19633,1384,6,21237,20295,942,4,21350,20602,748,3,48304,48153,48129,136,534,534,127,512,505,2948,7217,6364,9964
22063,LA,"Livingston Parish, LA",68836,64227,4609,6,70129,67411,2718,3,72126,70073,2053,2,142824,146230,148425,419,1842,1843,340,1317,1312,11814,34643,28060,18923
22065,LA,"Madison Parish, LA",3537,3220,317,9,3482,3242,240,6,3503,3327,176,5,9923,9804,9478,27,124,124,37,143,145,1665,2213,1879,1022
22067,LA,"Morehouse Parish, LA",10025,8994,1031,10,9991,9251,740,7,9947,9426,521,5,25453,25000,24446,75,295,295,118,499,489,3486,7169,4797,2003
22069,LA,"Natchitoches Parish, LA",16104,14940,1164,7,16494,15696,798,4,16687,16032,655,3,37388,36995,36663,106,427,429,109,528,527,2965,8634,6218,4916
22071,LA,"Orleans Parish, LA",179960,157659,22301,12,178283,163531,14752,8,176691,168780,7911,4,383218,377063,369749,1056,4352,4353,1309,4243,4149,32498,61685,73181,107461
22073,LA,"Ouachita Parish, LA",69470,64075,5395,7,70104,66501,3603,5,70659,68082,2577,3,160096,158919,157702,493,1944,1947,483,2006,1996,12376,34905,31429,26026
22075,LA,"Plaquemines Parish, LA",9542,8839,703,7,9587,9156,431,4,9805,9489,316,3,23458,23284,22516,54,236,236,63,239,237,2322,5444,4968,2633
22077,LA,"Pointe Coupee Parish, LA",9459,8675,784,8,9662,9102,560,5,9863,9481,382,3,20670,20323,20151,56,221,221,103,327,332,2757,5424,4213,2225
22079,LA,"Rapides Parish, LA",54760,51144,3616,6,55554,53230,2324,4,56381,54566,1815,3,129657,128748,127189,406,1638,1641,462,1894,1887,11268,32582,24182,18675
22081,LA,"Red River Parish, LA",3588,3353,235,6,3692,3527,165,4,3894,3766,128,3,7587,7490,7420,19,89,89,45,154,158,973,2689,944,649
22083,LA,"Richland Parish, LA",8107,7455,652,8,8169,7731,438,5,8287,7951,336,4,20032,19890,19826,68,272,270,56,303,306,2939,5462,3244,2115
22085,LA,"Sabine Parish, LA",9217,8675,542,5,9290,8931,359,3,9254,8952,302,3,22093,22098,21985,57,260,261,90,383,367,2126,7276,3954,1952
22087,LA,"St. Bernard Parish, LA",20017,17932,2085,10,19978,18612,1366,6,20012,19215,797,4,43853,44330,44479,133,571,572,125,443,436,5345,8887,10397,4231
22089,LA,"St. Charles Parish, LA",24393,22411,1982,8,24483,23229,1254,5,24818,23992,826,3,52507,52405,50998,145,600,599,154,533,529,3280,11356,10613,10038
22091,LA,"St. Helena Parish, LA",4243,3729,514,12,4305,3913,392,9,4302,4072,230,5,10901,10921,10822,30,105,105,38,167,166,1697,3266,1627,933
22093,LA,"St. James Parish, LA",8851,7943,908,10,8880,8221,659,7,8919,8508,411,4,20117,19790,19423,60,237,236,70,250,248,1979,5531,4040,2581
22095,LA,"St. John the Baptist Parish, LA",19203,16971,2232,11,19224,17580,1644,8,19119,18165,954,5,42355,42021,39864,115,477,481,155,513,500,3926,10965,8898,4537
22097,LA,"St. Landry Parish, LA",32216,29276,2940,9,32228,30175,2053,6,32013,30592,1421,4,82302,82283,81773,264,1165,1163,335,1231,1209,11745,20958,13306,7931
22099,LA,"St. Martin Parish, LA",21803,19936,1867,8,21988,20728,1260,5,22121,21311,810,3,51628,51573,51236,179,654,656,176,676,672,5731,16412,7918,5247
22101,LA,"St. Mary Parish, LA",19403,17538,1865,9,19215,17904,1311,6,19306,18485,821,4,49143,48188,47789,152,600,601,179,693,686,6483,15934,7662,4165
22103,LA,"St. Tammany Parish, LA",116827,108612,8215,7,117390,112701,4689,4,119821,116289,3532,2,264986,270087,273263,650,2930,2930,754,2781,2738,15677,44252,54629,65599
22105,LA,"Tangipahoa Parish, LA",56195,50576,5619,10,56450,52783,3667,6,56759,54306,2453,4,133635,135508,137048,455,1927,1930,376,1514,1496,15242,31218,21883,18362
22107,LA,"Tensas Parish, LA",1343,1224,119,8,1324,1244,80,6,1328,1262,66,5,4107,4034,3846,9,45,45,23,82,83,659,1296,613,396
22109,LA,"Terrebonne Parish, LA",45729,42013,3716,8,45153,42478,2675,5,44612,42885,1727,3,109405,109013,104786,376,1418,1419,332,1257,1275,13835,27924,19441,12126
22111,LA,"Union Parish, LA",8999,8321,678,7,9084,8630,454,5,9217,8868,349,3,21090,20996,20721,61,250,250,111,411,401,2005,6899,3507,2475
22113,LA,"Vermilion Parish, LA",23614,21773,1841,7,23952,22710,1242,5,24142,23290,852,3,56918,56854,56952,164,705,708,167,728,730,6460,15794,9448,6686
22115,LA,"Vernon Parish, LA",15810,14613,1197,7,16006,15242,764,4,16282,15623,659,4,48625,48056,47247,216,874,875,111,538,551,3599,11896,8967,5576
22117,LA,"Washington Parish, LA",16634,15203,1431,8,16888,15873,1015,6,17109,16396,713,4,45344,45176,45025,140,573,575,209,740,731,5743,13975,8171,3329
22119,LA,"Webster Parish, LA",13965,12803,1162,8,14062,13273,789,5,14221,13631,590,4,36875,36024,35643,95,405,406,137,691,691,3753,11104,7262,3727
22121,LA,"West Baton Rouge Parish, LA",13510,12493,1017,7,13789,13107,682,4,14085,13626,459,3,27258,27805,28034,100,385,386,84,301,306,2402,6925,5457,3915
22123,LA,"West Carroll Parish, LA",3656,3270,386,10,3531,3300,231,6,3537,3343,194,5,9693,9596,9475,22,103,102,34,175,170,1331,3314,1477,791
22125,LA,"West Feliciana Parish, LA",5178,4881,297,5,5321,5121,200,3,5472,5331,141,2,15250,15481,15381,24,101,101,53,172,174,2060,4168,2918,2704
22127,LA,"Winn Parish, LA",4691,4338,353,7,4599,4369,230,5,4649,4463,186,4,13721,13507,13205,28,131,131,58,230,234,1811,4624,2112,1397
23000,ME,Maine,670595,636655,33940,5,685168,653341,31827,4,674875,654965,19910,3,1363557,1377238,1385340,2997,11580,12030,3713,16100,17973,62607,307382,290461,334450
23001,ME,"Androscoggin County, ME",53905,51174,2731,5,54355,51684,2671,4,52717,51143,1574,3,111180,112648,113023,296,1094,1132,295,1352,1493,6308,27322,25579,17607
23003,ME,"Aroostook County, ME",29007,27516,1491,5,29162,27497,1665,5,28237,27068,1169,4,67064,67022,67255,153,604,634,205,1017,1122,4805,18973,15983,10133
23005,ME,"Cumberland County, ME",159617,151778,7839,4,163251,156698,6553,4,161629,157741,3888,2,303570,306149,307451,733,2767,2877,758,2945,3342,9503,44666,55894,109227
23007,ME,"Franklin County, ME",13634,12860,774,5,13875,13138,737,5,13642,13154,488,3,29460,30275,30474,55,220,228,63,354,406,1344,7839,6188,6018
23009,ME,"Hancock County, ME",27533,26050,1483,5,28675,27249,1426,5,28408,27417,991,3,55500,56403,56701,117,389,407,160,685,767,2025,13222,12085,15046
23011,ME,"Kennebec County, ME",60935,58128,2807,4,61683,59007,2676,4,60945,59223,1722,2,123832,124824,125540,279,1064,1107,370,1518,1679,5529,30621,26470,26468
23013,ME,"Knox County, ME",19430,18450,980,5,20028,19147,881,4,19738,19147,591,3,40657,41074,41164,67,272,283,107,506,546,1976,9759,7901,11188
23015,ME,"Lincoln County, ME",16276,15472,804,4,16865,16121,744,4,16492,16015,477,2,35249,35985,36215,61,240,251,115,453,493,1636,8609,6553,10109
23017,ME,"Oxford County, ME",25594,24022,1572,6,26389,24914,1475,5,25702,24853,849,3,57894,58719,59495,132,472,488,152,756,856,3551,17591,13143,9176
23019,ME,"Penobscot County, ME",73706,69996,3710,5,75081,71498,3583,4,74606,72300,2306,3,152165,152834,153704,307,1228,1274,407,1878,2103,7008,35630,33368,32587
23021,ME,"Piscataquis County, ME",7110,6750,360,5,7497,7119,378,5,7258,6982,276,3,16805,17184,17417,30,126,130,57,274,297,1113,5043,4136,2619
23023,ME,"Sagadahoc County, ME",19113,18271,842,4,19282,18561,721,3,18883,18433,450,2,36724,37190,37393,72,289,298,86,394,434,1623,7851,7515,10522
23025,ME,"Somerset County, ME",21865,20514,1351,6,22435,21031,1404,6,21789,20891,898,4,50460,50715,51098,125,459,475,154,704,771,3375,15546,11150,7461
23027,ME,"Waldo County, ME",19846,18899,947,4,20369,19409,960,4,20148,19511,637,3,39654,39984,40241,90,341,353,112,472,536,2043,9530,8172,9681
23029,ME,"Washington County, ME",13259,12485,774,5,13506,12636,870,6,13244,12679,565,4,31087,31166,31437,54,258,267,126,526,568,2010,8588,6731,5469
23031,ME,"York County, ME",109765,104294,5471,5,112715,107631,5084,4,111436,108410,3026,2,212256,215066,216732,426,1757,1826,546,2266,2560,8758,46592,49593,51139
24000,MD,Maryland,3241086,3031031,210055,6,3173289,3005067,168222,5,3171513,3068700,102813,3,6173205,6174610,6164660,17156,67441,69130,16908,58911,57567,391353,1014292,1072668,1762482
24001,MD,"Allegany County, MD",31462,29105,2357,7,30594,28777,1817,5,31102,29849,1253,4,67955,67691,67267,148,622,635,261,1149,1128,4682,19630,14082,9700
24003,MD,"Anne Arundel County, MD",318737,300973,17764,5,312824,299102,13722,4,313385,304493,8892,2,589054,592052,593286,1727,6709,6866,1319,4984,4869,26594,90783,112843,172982
24005,MD,"Baltimore County, MD",454046,424267,29779,6,444843,421591,23252,5,443836,429164,14672,3,853325,850634,846161,2364,9217,9441,2748,9744,9409,49577,146153,155884,238633
24009,MD,"Calvert County, MD",49913,47420,2493,5,48814,46746,2068,4,49346,47891,1455,2,92905,94226,94573,232,923,944,230,816,799,3476,18283,19063,22669
24011,MD,"Caroline County, MD",17771,16818,953,5,17100,16332,768,4,17107,16581,526,3,33273,33413,33433,89,397,414,98,415,416,3434,8928,6020,4310
24013,MD,"Carroll County, MD",95420,90766,4654,4,93937,90301,3636,3,94578,92067,2511,2,172923,174208,175305,450,1634,1669,539,1804,1785,7445,33819,33116,45529
24015,MD,"Cecil County, MD",53703,50659,3044,5,52729,50197,2532,4,53761,51972,1789,3,103793,104096,104942,277,1077,1105,309,1192,1179,6595,25478,21330,18437
24017,MD,"Charles County, MD",88542,82869,5673,6,86168,81629,4539,5,86546,83670,2876,3,166726,168870,170102,433,1753,1804,405,1396,1407,7043,33092,36508,34610
24019,MD,"Dorchester County, MD",16613,15564,1049,6,15942,15097,845,5,15983,15408,575,3,32528,32625,32726,95,374,383,111,447,449,2927,9207,6513,4621
24021,MD,"Frederick County, MD",138108,130318,7790,5,134692,128703,5989,4,136010,131997,4013,3,272765,280410,287079,771,2921,2998,641,2169,2127,12892,43666,48832,77114
24023,MD,"Garrett County, MD",15664,14665,999,6,15236,14488,748,4,14983,14466,517,3,28792,28757,28579,95,263,270,93,443,437,2059,8980,5146,5311
24025,MD,"Harford County, MD",141932,134078,7854,5,139382,133211,6171,4,139847,135697,4150,3,261213,263292,263867,627,2532,2601,627,2549,2536,11297,47168,53824,67945
24027,MD,"Howard County, MD",189779,180388,9391,4,186764,179263,7501,4,187382,182454,4928,2,332786,335287,335411,827,3295,3379,560,2041,2044,10307,28642,42233,141664
24029,MD,"Kent County, MD",9872,9246,626,6,9524,9037,487,5,9734,9384,350,3,19114,19254,19320,39,149,151,105,315,307,1297,4377,2956,5173
24031,MD,"Montgomery County, MD",559037,525071,33966,6,546559,518901,27658,5,546813,530944,15869,2,1060825,1055924,1052521,2874,11503,11799,2413,7482,7317,63938,95734,133591,435904
24033,MD,"Prince George's County, MD",514828,474418,40410,7,501438,467541,33897,6,496637,479080,17557,3,965290,956254,946971,2796,11113,11385,2701,8111,7841,83413,166067,175601,228098
24035,MD,"Queen Anne's County, MD",28215,26743,1472,5,27781,26657,1124,4,28005,27231,774,2,50023,50900,51711,143,468,481,126,458,452,2536,9890,9990,13144
24037,MD,"St. Mary's County, MD",58747,56020,2727,4,58355,55967,2388,4,57662,55891,1771,3,113987,114664,114877,327,1355,1396,272,995,990,6268,23515,20603,24854
24039,MD,"Somerset County, MD",8751,8040,711,8,8862,8247,615,6,9019,8588,431,4,24564,24528,24546,47,213,217,80,351,346,2791,6068,4943,2831
24041,MD,"Talbot County, MD",18051,17001,1050,5,17322,16460,862,5,17483,16895,588,3,37481,37796,37932,95,377,382,135,554,546,2374,6540,7890,11674
24043,MD,"Washington County, MD",73270,68454,4816,6,72392,68793,3599,5,72276,69875,2401,3,154677,155197,155590,416,1655,1699,463,1952,1921,12860,39055,31532,24423
24045,MD,"Wicomico County, MD",50011,46387,3624,7,50306,47474,2832,5,51069,49104,1965,3,103556,104181,104664,336,1224,1251,313,1181,1179,7957,20614,17696,18726
24047,MD,"Worcester County, MD",25356,22582,2774,10,25002,23123,1879,7,25185,23919,1266,5,52511,53370,53866,96,393,402,169,742,746,2875,11941,12852,12200
24510,MD,"Baltimore city, MD",283257,259179,24078,8,276725,257430,19295,7,273763,262081,11682,4,583139,576981,569931,1852,7274,7458,2190,7621,7337,56716,116662,99620,141930
25000,MA,Massachusetts,3750155,3399381,350774,9,3742987,3535696,207291,5,3743924,3603172,140752,3,6995729,6989690,6981974,17112,66541,70019,22124,61675,63716,433215,1137085,1116219,2216349
25001,MA,"Barnstable County, MA",110528,98661,11867,10,111971,104728,7243,6,111609,106317,5292,4,228856,232594,232457,354,1434,1510,891,3097,3182,7686,39626,50878,79930
25003,MA,"Berkshire County, MA",61529,55443,6086,9,61998,57996,4002,6,61961,59260,2701,4,128774,128621,127859,248,904,950,416,1672,1686,6625,27808,26447,34347
25005,MA,"Bristol County, MA",300722,268295,32427,10,298839,280006,18833,6,298575,284709,13866,4,576737,579895,580068,1455,5283,5554,1928,5815,6033,57348,122075,106707,118733
25007,MA,"Dukes County, MA",9098,8160,938,10,9604,8995,609,6,9592,9089,503,5,20579,21109,20868,45,178,188,49,166,170,652,3945,3795,7164
25009,MA,"Essex County, MA",425131,381200,43931,10,422709,396815,25894,6,420933,404395,16538,3,808491,807485,806765,2026,8199,8630,2710,7422,7688,57431,136493,135347,230608
25011,MA,"Franklin County, MA",40086,36913,3173,7,40334,38369,1965,4,40138,38784,1354,3,70930,70943,70894,117,484,512,265,760,766,3450,15077,14453,20952
25013,MA,"Hampden County, MA",226764,201994,24770,10,226252,209869,16383,7,223322,212327,10995,4,464407,462849,461041,1189,4728,4971,1785,5103,5264,44183,96780,87767,89906
25015,MA,"Hampshire County, MA",88669,81965,6704,7,89213,85169,4044,4,89177,86161,3016,3,146592,163088,162588,262,932,966,455,1409,1421,4744,21612,23495,50304
25017,MA,"Middlesex County, MA",903742,834270,69472,7,905149,864550,40599,4,909392,881480,27912,3,1628671,1617099,1617105,4137,15672,16496,4639,12144,12542,73449,206435,202660,659984
25019,MA,"Nantucket County/town, MA",7174,6334,840,11,7766,7191,575,7,7868,7371,497,6,14237,14499,14421,30,139,143,22,74,81,388,1863,2785,5179
25021,MA,"Norfolk County, MA",391267,356908,34359,8,390055,370682,19373,5,392356,379275,13081,3,724322,724692,725531,1720,6937,7297,2330,6088,6290,29456,91670,104228,281499
25023,MA,"Plymouth County, MA",284260,256005,28255,9,283210,266532,16678,5,283384,272123,11261,4,530154,532919,533069,1216,5138,5429,1865,5259,5455,25872,98953,99590,145456
25025,MA,"Suffolk County, MA",457702,410752,46950,10,452475,426490,25985,5,452927,436502,16425,3,793271,771765,766381,2197,8222,8650,2101,5067,5275,71809,115175,99726,266176
25027,MA,"Worcester County, MA",443482,402482,41000,9,443413,418305,25108,5,442688,425380,17308,3,859708,862132,862927,2116,8291,8723,2668,7599,7863,50122,159573,158341,226111
26000,MI,Michigan,4863008,4379122,483886,10,4779555,4501562,277993,5,4835966,4632539,203427,4,10069577,10037504,10034113,26586,102739,105157,31049,115020,117639,582901,1971279,2249290,2119662
26001,MI,"Alcona County, MI",3857,3458,399,10,3736,3474,262,7,3841,3574,267,7,10189,10300,10417,24,71,71,42,203,211,799,3167,2759,1622
26003,MI,"Alger County, MI",3133,2783,350,11,3104,2860,244,7,3228,2989,239,7,8842,8789,8807,21,65,67,23,97,101,575,3181,1852,1226
26005,MI,"Allegan County, MI",62271,57568,4703,7,60597,57775,2822,4,61711,59418,2293,3,120647,121010,121210,288,1198,1209,288,1283,1286,7075,29807,25198,19314
26007,MI,"Alpena County, MI",13270,12207,1063,8,13157,12434,723,5,13192,12532,660,5,28880,28916,28847,61,238,244,90,411,415,1570,7783,8515,3609
26009,MI,"Antrim County, MI",10156,9129,1027,10,9888,9204,684,6,10102,9513,589,5,23459,23884,24249,37,171,172,61,312,318,1214,5486,5660,5295
26011,MI,"Arenac County, MI",5967,5270,697,11,5699,5231,468,8,5787,5360,427,7,15003,15000,15089,28,126,130,57,247,256,1267,4363,4061,1622
26013,MI,"Baraga County, MI",3159,2773,386,12,3016,2784,232,7,3064,2840,224,7,8140,8291,8277,18,86,89,23,123,133,557,2535,2231,915
26015,MI,"Barry County, MI",31539,29133,2406,7,30898,29487,1411,4,31787,30561,1226,3,62598,63170,63554,168,594,592,153,628,647,2866,15584,14640,10500
26017,MI,"Bay County, MI",49575,44856,4719,9,48066,45168,2898,6,48944,46404,2540,5,103733,103251,102821,251,917,938,336,1499,1562,6699,25610,27665,15275
26019,MI,"Benzie County, MI",8698,7853,845,9,8480,7980,500,5,8743,8278,465,5,17997,18236,18297,34,142,141,59,263,271,953,3932,4236,4453
26021,MI,"Berrien County, MI",72746,66171,6575,9,69967,65936,4031,5,71619,68355,3264,4,154183,153377,152900,387,1500,1541,486,1864,1922,9974,30270,36489,31324
26023,MI,"Branch County, MI",19753,18109,1644,8,19240,18294,946,4,19616,18807,809,4,44868,45202,44531,154,555,565,144,528,541,3446,12854,9908,4760
26025,MI,"Calhoun County, MI",62032,55821,6211,10,59353,55512,3841,6,59789,56904,2885,4,134184,133878,133289,379,1458,1490,443,1891,1952,8213,32606,30732,19950
26027,MI,"Cass County, MI",24457,22223,2234,9,23174,21996,1178,5,23458,22414,1044,4,51550,51501,51403,117,455,468,152,677,685,4041,12627,12560,7729
26029,MI,"Charlevoix County, MI",12560,11283,1277,10,12342,11612,730,5,12784,12179,605,4,26034,26215,26293,57,211,216,72,281,287,1166,5378,6534,6301
26031,MI,"Cheboygan County, MI",10353,8816,1537,14,10029,9185,844,8,10300,9444,856,8,25584,25735,25940,36,157,161,106,386,398,1831,7075,6358,4474
26033,MI,"Chippewa County, MI",15973,14475,1498,9,15604,14583,1021,6,16006,14988,1018,6,36781,35867,36293,75,286,298,78,393,403,2044,8709,9197,6086
26035,MI,"Clare County, MI",11750,10342,1408,12,11166,10282,884,7,11238,10454,784,7,30834,31128,31352,64,285,291,98,508,518,3044,8880,7913,2720
26037,MI,"Clinton County, MI",40374,37653,2721,6,38984,37246,1738,4,40034,38471,1563,3,79157,79499,79748,191,698,699,169,742,743,2588,13985,20262,17800
26039,MI,"Crawford County, MI",5613,5001,612,10,5376,5002,374,7,5480,5121,359,6,12993,13292,13491,32,110,111,48,182,186,859,3058,3917,2108
26041,MI,"Delta County, MI",16893,15360,1533,9,16366,15372,994,6,16573,15649,924,5,36860,36834,36741,77,330,338,119,583,616,1971,9635,10389,5076
26043,MI,"Dickinson County, MI",12171,11277,894,7,12205,11624,581,4,12186,11656,530,4,25898,25795,25874,55,230,234,76,403,408,827,6255,7481,4482
26045,MI,"Eaton County, MI",56349,51903,4446,7,54195,51306,2889,5,55768,53295,2473,4,109176,109030,108992,283,1053,1031,277,1225,1251,3912,20296,29497,23292
26047,MI,"Emmet County, MI",17233,15384,1849,10,16556,15528,1028,6,16760,15828,932,5,34104,34280,34163,71,259,265,96,434,450,1146,6260,8235,9172
26049,MI,"Genesee County, MI",180263,159494,20769,11,175248,162185,13063,7,178083,168128,9955,5,405757,404662,401983,1052,4255,4389,1490,5364,5551,24774,88331,104637,62266
26051,MI,"Gladwin County, MI",9871,8874,997,10,9703,9032,671,6,9886,9287,599,6,25375,25528,25728,44,246,251,96,439,454,2200,7342,6631,2678
26053,MI,"Gogebic County, MI",5838,5369,469,8,5624,5315,309,5,5680,5384,296,5,14346,14356,14319,28,93,94,51,253,259,668,3866,4421,2477
26055,MI,"Grand Traverse County, MI",49216,44967,4249,8,48093,45701,2392,5,49402,47541,1861,3,95411,96013,96464,231,897,931,247,1030,1060,3305,15170,23598,26253
26057,MI,"Gratiot County, MI",17869,16396,1473,8,17067,16119,948,5,17298,16495,803,4,41667,41269,41100,87,369,378,137,550,565,2364,11925,9817,4872
26059,MI,"Hillsdale County, MI",20175,18294,1881,9,19781,18703,1078,5,20129,19205,924,4,45733,45609,45762,131,491,501,169,636,637,3212,12643,9734,5748
26061,MI,"Houghton County, MI",15951,14740,1211,7,15801,15008,793,5,16218,15433,785,4,37238,37444,37035,79,354,364,76,424,424,1568,6767,6364,7432
26063,MI,"Huron County, MI",15485,14122,1363,8,14840,14043,797,5,14963,14258,705,4,31371,31354,31248,68,288,297,105,494,506,2103,9780,7639,3778
26065,MI,"Ingham County, MI",146981,135577,11404,7,141934,134011,7923,5,145700,139226,6474,4,284640,271427,284108,740,2844,2973,661,2609,2685,11032,37572,55399,71050
26067,MI,"Ionia County, MI",30259,27777,2482,8,29708,28294,1414,4,30185,29006,1179,3,66855,66797,66809,175,620,635,138,608,616,3879,18501,15989,7349
26069,MI,"Iosco County, MI",10149,9046,1103,10,9845,9144,701,7,10233,9577,656,6,25185,25374,25521,47,197,201,107,460,475,2069,7125,7263,3157
26071,MI,"Iron County, MI",4950,4529,421,8,4743,4456,287,6,4724,4440,284,6,11628,11576,11622,19,73,73,54,253,258,690,3872,2647,1714
26073,MI,"Isabella County, MI",33107,30246,2861,8,31843,30166,1677,5,31715,30169,1546,4,64513,64291,64447,158,587,598,130,651,646,2742,11547,11300,11058
26075,MI,"Jackson County, MI",74670,67766,6904,9,71930,67825,4105,5,73791,70491,3300,4,160225,160266,160066,402,1672,1716,471,1976,2035,9178,38277,39530,25413
26077,MI,"Kalamazoo County, MI",132296,122352,9944,7,128361,121925,6436,5,131436,126245,5191,3,261767,260688,261173,732,2732,2792,621,2552,2580,9380,37053,51636,66595
26079,MI,"Kalkaska County, MI",7898,6991,907,11,7654,7107,547,7,7862,7392,470,6,17916,17958,18182,41,154,155,58,249,250,1540,5073,4255,2055
26081,MI,"Kent County, MI",357380,329198,28182,7,349619,333242,16377,4,359534,346976,12558,3,658460,659000,659083,2104,8093,8316,1366,5663,5850,34424,104608,130702,166025
26083,MI,"Keweenaw County, MI",898,816,82,9,890,831,59,6,904,849,55,6,2068,2118,2180,6,16,16,5,27,27,59,458,526,608
26085,MI,"Lake County, MI",3970,3527,443,11,3834,3523,311,8,3885,3611,274,7,12094,12261,12594,17,79,80,44,211,218,1711,3847,2683,1245
26087,MI,"Lapeer County, MI",40600,35651,4949,12,40163,37743,2420,6,40156,38435,1721,4,88572,88686,88780,196,752,768,274,1028,1041,5270,23202,23125,11823
26089,MI,"Leelanau County, MI",10253,9411,842,8,10080,9561,519,5,10300,9861,439,4,22312,22630,22870,37,142,141,70,288,300,632,3618,4890,8189
26091,MI,"Lenawee County, MI",45756,41546,4210,9,44574,42137,2437,5,44786,42695,2091,4,99320,99202,98567,248,948,975,272,1254,1265,5911,25545,22605,15118
26093,MI,"Livingston County, MI",101006,92311,8695,8,101971,97724,4247,4,102705,99778,2927,2,193971,195277,196161,439,1666,1672,467,1772,1785,5547,34379,45188,51798
26095,MI,"Luce County, MI",2233,2032,201,9,2139,1991,148,6,2117,1985,132,6,5336,5337,5330,12,40,42,19,69,72,323,1593,1570,760
26097,MI,"Mackinac County, MI",4951,4271,680,13,4856,4438,418,8,5085,4623,462,9,10816,10899,10941,15,70,73,51,165,175,723,3033,2609,2088
26099,MI,"Macomb County, MI",443160,391142,52018,11,439919,414146,25773,5,440043,423756,16287,3,880176,877385,874195,2307,8732,8937,3198,10600,10789,59857,182867,217334,162897
26101,MI,"Manistee County, MI",10207,9060,1147,11,9694,8993,701,7,9751,9174,577,5,25061,25299,25287,41,175,181,83,408,410,1664,6295,6746,4152
26103,MI,"Marquette County, MI",31782,29057,2725,8,30950,29309,1641,5,31807,30224,1583,5,66012,65800,66661,148,553,568,144,721,740,2090,12711,14414,15123
26105,MI,"Mason County, MI",13329,12049,1280,9,13031,12201,830,6,13174,12475,699,5,29038,29381,29409,56,243,248,109,393,407,1417,7418,7401,4931
26107,MI,"Mecosta County, MI",18381,16641,1740,9,17835,16708,1127,6,18207,17198,1009,5,39792,40057,40720,111,374,379,111,499,512,1919,9150,8091,6178
26109,MI,"Menominee County, MI",10683,9969,714,6,10504,10030,474,4,10644,10190,454,4,23450,23323,23266,39,172,174,68,311,317,1221,7360,5855,3054
26111,MI,"Midland County, MI",39388,36304,3084,7,38592,36711,1881,4,39895,38161,1734,4,83481,83426,83674,182,767,787,209,906,935,3114,16603,18071,20868
26113,MI,"Missaukee County, MI",6929,6274,655,9,6841,6464,377,5,6789,6446,343,5,15057,15164,15213,35,151,153,46,195,202,1036,4384,3507,1603
26115,MI,"Monroe County, MI",74492,67671,6821,9,72122,67771,4351,6,74453,70861,3592,4,154893,155646,155609,403,1531,1574,455,1755,1819,9276,36909,39338,23625
26117,MI,"Montcalm County, MI",27929,25289,2640,9,27109,25599,1510,5,27766,26511,1255,4,66648,67458,67433,194,708,730,144,731,747,5359,18643,16026,6478
26119,MI,"Montmorency County, MI",3022,2610,412,13,2954,2684,270,9,3018,2772,246,8,9164,9302,9569,16,77,82,40,193,198,864,2974,2388,1042
26121,MI,"Muskegon County, MI",77752,68560,9192,11,75488,69977,5511,7,76671,72763,3908,5,175848,176612,176565,495,1855,1902,543,2151,2238,10020,41547,44434,24703
26123,MI,"Newaygo County, MI",23379,21283,2096,9,22856,21576,1280,5,23161,22063,1098,4,50095,50468,50886,135,525,529,125,576,586,3560,14404,10854,5956
26125,MI,"Oakland County, MI",654755,595203,59552,9,660789,630128,30661,4,664232,644401,19831,3,1272413,1271891,1269431,3195,12121,12399,3737,12711,12893,48382,164045,249010,442235
26127,MI,"Oceana County, MI",12049,10751,1298,10,11585,10738,847,7,11407,10659,748,6,26713,26884,26973,68,271,275,76,323,341,2160,6837,5818,3766
26129,MI,"Ogemaw County, MI",8081,7166,915,11,7950,7338,612,7,8229,7653,576,7,20779,20783,20970,42,177,182,66,343,349,2015,5957,5558,2074
26131,MI,"Ontonagon County, MI",2052,1831,221,10,2010,1858,152,7,2002,1852,150,7,5805,5855,5863,9,23,23,29,129,137,328,2165,1649,730
26133,MI,"Osceola County, MI",11561,10568,993,8,11252,10629,623,5,11285,10752,533,4,22906,23176,23274,65,239,245,69,276,274,1810,6732,5146,2457
26135,MI,"Oscoda County, MI",2808,2447,361,12,2667,2431,236,8,2783,2563,220,7,8239,8328,8404,26,83,81,32,166,175,1097,2234,1971,834
26137,MI,"Otsego County, MI",11652,10418,1234,10,11407,10645,762,6,11486,10864,622,5,25138,25351,25644,63,240,251,75,323,332,1146,5638,6313,4797
26139,MI,"Ottawa County, MI",160033,148750,11283,7,156982,150580,6402,4,161616,156266,5350,3,296889,298317,300873,749,3032,3089,580,2470,2555,11495,48490,58744,65818
26141,MI,"Presque Isle County, MI",4959,4387,572,11,4793,4418,375,7,4900,4523,377,7,12997,13173,13361,20,100,101,48,205,210,938,3770,3528,1953
26143,MI,"Roscommon County, MI",7771,6787,984,12,7472,6774,698,9,7930,7254,676,8,23466,23677,23708,40,147,152,87,468,472,1721,6516,7318,3217
26145,MI,"Saginaw County, MI",84794,76066,8728,10,81642,75966,5676,7,82601,78002,4599,5,189860,189590,188330,515,1960,2003,695,2624,2741,12429,42795,46899,29353
26147,MI,"St. Clair County, MI",74803,66061,8742,11,74301,69936,4365,5,74282,71387,2895,3,160375,160384,160151,378,1481,1520,496,2101,2142,9317,38260,44485,22155
26149,MI,"St. Joseph County, MI",29121,26399,2722,9,27811,26387,1424,5,28305,27098,1207,4,60931,60850,60874,174,698,716,166,758,767,5404,14994,13882,6743
26151,MI,"Sanilac County, MI",19484,17534,1950,10,18960,17808,1152,6,18809,17821,988,5,40502,40604,40657,86,406,417,125,554,574,2918,12480,9333,4340
26153,MI,"Schoolcraft County, MI",3252,2924,328,10,3108,2859,249,8,3106,2865,241,7,8056,8060,8188,19,72,72,32,131,136,605,2550,1852,1154
26155,MI,"Shiawassee County, MI",32846,29743,3103,9,31760,29961,1799,5,32187,30651,1536,4,68006,67998,68022,162,654,672,219,828,848,3840,17298,18326,8795
26157,MI,"Tuscola County, MI",23701,21231,2470,10,22685,21266,1419,6,22886,21644,1242,5,53310,53046,52945,133,503,520,185,759,780,3649,17211,12168,5446
26159,MI,"Van Buren County, MI",34830,31808,3022,8,33768,31731,2037,6,34141,32402,1739,5,75576,75703,75692,179,787,801,203,910,927,6089,16781,18026,11143
26161,MI,"Washtenaw County, MI",194032,181053,12979,6,188812,180627,8185,4,194931,187847,7084,3,371817,364998,366376,890,3181,3218,729,2667,2719,10043,34379,56054,134255
26163,MI,"Wayne County, MI",803161,694576,108585,13,795757,733422,62335,7,789916,753274,36642,4,1789129,1773073,1757043,5507,21476,22018,7350,22267,22684,149959,358049,389712,312420
26165,MI,"Wexford County, MI",14931,13362,1569,10,14655,13795,860,5,14773,14049,724,4,33685,33940,34196,88,352,366,100,380,389,2218,8370,7992,4713
27000,MN,Minnesota,3134161,2938015,196146,6,3039323,2924148,115175,3,3077500,2994920,82580,2,5709852,5711471,5717184,16461,63068,64821,12756,51473,53204,247610,919096,1235333,1445462
27001,MN,"Aitkin County, MN",7543,6920,623,8,7394,7012,382,5,7459,7122,337,4,15718,15945,16126,33,100,103,54,262,259,997,4602,4517,2107
27003,MN,"Anoka County, MN",201764,188755,13009,6,194813,187425,7388,3,198440,193204,5236,2,364458,367416,368864,1033,4032,4149,670,2723,2838,14435,67611,87316,77093
27005,MN,"Becker County, MN",19099,17891,1208,6,19118,18423,695,3,19393,18821,572,2,35194,35326,35371,106,357,369,91,425,431,1695,6982,9100,6183
27007,MN,"Beltrami County, MN",25096,23488,1608,6,24536,23544,992,4,25036,24215,821,3,46243,46420,46799,134,580,598,128,533,543,1994,7813,9908,8616
27009,MN,"Benton County, MN",22261,20764,1497,6,21445,20431,1014,4,21608,20865,743,3,41357,41496,41463,122,478,487,106,457,454,2358,7809,10729,6192
27011,MN,"Big Stone County, MN",2564,2441,123,4,2448,2356,92,3,2399,2321,78,3,5158,5162,5144,14,58,59,15,79,79,301,1444,1240,752
27013,MN,"Blue Earth County, MN",40969,38739,2230,5,39617,38271,1346,3,40267,39356,911,2,69211,69361,69631,195,688,708,146,555,575,2099,10092,13809,14338
27015,MN,"Brown County, MN",14353,13603,750,5,13713,13248,465,3,13773,13399,374,2,25903,25883,25723,73,259,268,71,330,340,1208,6317,5983,4186
27017,MN,"Carlton County, MN",17878,16566,1312,7,17385,16618,767,4,17578,16945,633,3,36193,36455,36708,96,360,375,84,449,467,1573,8281,9494,6086
27019,MN,"Carver County, MN",60002,56862,3140,5,58099,56330,1769,3,59251,57973,1278,2,107284,108826,110034,250,1120,1162,142,650,666,2634,12397,19788,34388
27021,MN,"Cass County, MN",14593,13253,1340,9,15709,14943,766,4,14729,14110,619,4,30142,30638,31274,63,275,281,86,417,432,1395,7093,8081,5305
27023,MN,"Chippewa County, MN",6824,6471,353,5,6594,6380,214,3,6480,6322,158,2,12596,12390,12284,36,155,152,32,171,174,786,2890,3275,1656
27025,MN,"Chisago County, MN",30481,28437,2044,6,29411,28200,1211,4,29924,29002,922,3,56713,57544,57988,153,579,595,104,522,538,1832,12787,15820,8773
27027,MN,"Clay County, MN",36746,35138,1608,4,36854,35761,1093,3,37587,36777,810,2,65332,65665,65929,222,810,848,154,541,559,2030,8818,14502,14257
27029,MN,"Clearwater County, MN",4569,4119,450,9,4381,4095,286,6,4504,4207,297,6,8571,8574,8649,31,100,102,21,121,125,792,2083,1895,1025
27031,MN,"Cook County, MN",3019,2765,254,8,2954,2812,142,4,2850,2749,101,3,5595,5623,5708,7,33,34,13,56,54,152,1058,1321,1863
27033,MN,"Cottonwood County, MN",6396,6089,307,4,6540,6297,243,3,6664,6477,187,2,11509,11578,11356,31,133,138,35,176,175,695,2696,2685,1738
27035,MN,"Crow Wing County, MN",32646,30250,2396,7,32777,31351,1426,4,33477,32390,1087,3,66277,67345,67948,165,634,651,160,792,807,2838,13821,18360,12228
27037,MN,"Dakota County, MN",246040,230658,15382,6,237397,229043,8354,3,241932,236152,5780,2,440393,442773,443341,1192,4929,5060,797,3179,3302,14490,59045,94193,127587
27039,MN,"Dodge County, MN",12165,11501,664,5,11866,11458,408,3,11907,11591,316,2,20895,20964,20981,66,246,252,30,163,165,568,4337,4970,3882
27041,MN,"Douglas County, MN",21481,20442,1039,4,21438,20783,655,3,21530,21023,507,2,39089,39305,39668,105,401,412,105,487,491,1290,8281,10679,7451
27043,MN,"Faribault County, MN",7183,6735,448,6,6967,6682,285,4,7067,6844,223,3,13901,13910,13926,31,119,124,41,199,198,735,3424,3710,1996
27045,MN,"Fillmore County, MN",11794,11186,608,5,11416,11041,375,3,11427,11127,300,2,21234,21303,21414,60,228,234,70,253,257,1217,4766,5265,3243
27047,MN,"Freeborn County, MN",16369,15432,937,5,15758,15160,598,3,15839,15414,425,2,30902,30808,30718,89,305,311,97,397,406,2588,7629,8088,3685
27049,MN,"Goodhue County, MN",26984,25390,1594,5,26463,25532,931,3,26680,25993,687,2,47575,48018,48013,129,482,492,132,589,588,1882,11271,11493,8942
27051,MN,"Grant County, MN",3377,3195,182,5,3271,3139,132,4,3261,3165,96,2,6094,6161,6136,22,67,68,16,76,80,308,1404,1792,798
27053,MN,"Hennepin County, MN",717935,670358,47577,6,692722,666210,26512,3,703573,686159,17414,2,1281568,1266736,1260121,3901,14584,14983,3008,10066,10548,54200,138698,232592,458141
27055,MN,"Houston County, MN",10452,9996,456,4,10362,10040,322,3,10453,10215,238,2,18851,18829,18800,58,178,184,48,215,218,613,4566,4820,3398
27057,MN,"Hubbard County, MN",10099,9377,722,7,10214,9761,453,4,10169,9742,427,4,21392,21745,21960,47,209,219,49,246,252,862,4465,5557,4555
27059,MN,"Isanti County, MN",22056,20548,1508,6,21337,20372,965,4,21709,20980,729,3,41385,41951,42727,97,456,474,79,394,417,2256,9667,10868,5277
27061,MN,"Itasca County, MN",22359,20426,1933,8,21689,20576,1113,5,21727,20749,978,4,45035,45058,45205,112,366,379,136,641,652,1829,9923,12616,8188
27063,MN,"Jackson County, MN",5854,5544,310,5,5504,5314,190,3,5416,5280,136,2,9992,10015,9893,26,95,95,23,112,112,510,2523,2517,1577
27065,MN,"Kanabec County, MN",9200,8448,752,8,9049,8529,520,5,9215,8783,432,4,16049,16187,16463,50,156,157,51,205,211,1140,4272,4335,1697
27067,MN,"Kandiyohi County, MN",24868,23652,1216,4,23472,22560,912,3,23213,22547,666,2,43726,43865,43839,160,541,551,98,446,463,2570,7933,11282,7365
27069,MN,"Kittson County, MN",2415,2301,114,4,2268,2196,72,3,2228,2165,63,2,4198,4162,4059,8,35,37,12,83,76,128,1092,985,776
27071,MN,"Koochiching County, MN",5869,5429,440,7,5717,5443,274,4,5813,5579,234,4,12025,11944,11844,22,93,93,39,177,185,704,3157,3854,1487
27073,MN,"Lac qui Parle County, MN",3548,3376,172,4,3373,3267,106,3,3400,3308,92,2,6702,6715,6689,21,71,71,22,103,106,294,1848,1813,954
27075,MN,"Lake County, MN",5382,4989,393,7,5377,5166,211,3,5336,5070,266,5,10918,11009,10939,36,91,95,42,163,167,536,2553,2929,2117
27077,MN,"Lake of the Woods County, MN",2458,2305,153,6,2412,2316,96,4,2403,2325,78,3,3764,3821,3871,9,34,34,15,52,55,68,929,1198,617
27079,MN,"Le Sueur County, MN",16264,15142,1122,6,15651,14935,716,4,15898,15329,569,3,28639,28918,29153,61,290,304,57,254,272,1023,6769,7193,4680
27081,MN,"Lincoln County, MN",3162,3019,143,4,3046,2932,114,3,3029,2941,88,2,5628,5563,5580,17,66,67,24,90,92,248,1492,1407,837
27083,MN,"Lyon County, MN",14721,14061,660,4,14293,13865,428,3,14421,14061,360,2,25170,25267,25262,78,333,341,59,263,265,1126,4725,5943,4332
27085,MN,"McLeod County, MN",19495,18368,1127,5,19116,18394,722,3,19257,18701,556,2,36738,36807,36714,107,379,386,103,423,436,1575,8615,10289,4895
27087,MN,"Mahnomen County, MN",2226,1933,293,13,2181,2036,145,6,2234,2125,109,4,5372,5387,5328,18,73,74,20,86,94,444,1198,1211,424
27089,MN,"Marshall County, MN",5504,5139,365,6,5294,5054,240,4,5357,5142,215,4,9026,8979,8861,21,99,101,19,106,108,517,2463,2121,1217
27091,MN,"Martin County, MN",10137,9589,548,5,9641,9299,342,3,9618,9358,260,2,19982,19899,19650,51,207,213,55,271,285,954,5053,5197,3080
27093,MN,"Meeker County, MN",13417,12698,719,5,13193,12704,489,3,13551,13153,398,2,23431,23391,23496,52,238,248,58,264,263,964,5642,6117,3094
27095,MN,"Mille Lacs County, MN",13004,11883,1121,8,12482,11765,717,5,12667,12097,570,4,26462,26892,27280,81,274,282,89,373,383,1771,6513,7019,2936
27097,MN,"Morrison County, MN",18098,16855,1243,6,17482,16642,840,4,17275,16512,763,4,33995,34071,34246,75,331,344,69,398,414,1903,9082,8356,4206
27099,MN,"Mower County, MN",21035,19965,1070,5,20629,19920,709,3,20746,20218,528,2,40054,40214,40140,128,479,493,94,422,437,2838,8689,8896,6326
27101,MN,"Murray County, MN",4898,4645,253,5,4710,4516,194,4,4654,4500,154,3,8172,8145,8060,19,74,76,12,84,99,578,2116,1909,1243
27103,MN,"Nicollet County, MN",21021,19996,1025,4,20342,19722,620,3,20648,20234,414,2,34504,34373,34441,87,333,342,83,272,281,1118,5412,7876,7830
27105,MN,"Nobles County, MN",11710,11209,501,4,11308,10954,354,3,11087,10837,250,2,22207,22047,21947,84,358,364,46,222,217,2964,4355,4347,2328
27107,MN,"Norman County, MN",3341,3127,214,6,3189,3051,138,4,3190,3076,114,3,6435,6442,6377,20,67,69,18,77,84,351,1561,1586,979
27109,MN,"Olmsted County, MN",92206,87167,5039,5,90609,87783,2826,3,91063,89076,1987,2,163028,163620,164020,482,1921,1974,325,1276,1300,5482,21345,30691,51314
27111,MN,"Otter Tail County, MN",31842,30093,1749,5,31337,30178,1159,3,31357,30411,946,3,60072,60222,60519,150,598,615,190,775,810,3134,11588,16378,11405
27113,MN,"Pennington County, MN",8756,8211,545,6,8696,8346,350,4,8815,8522,293,3,13950,13806,13845,30,141,141,25,141,148,477,3026,4235,1895
27115,MN,"Pine County, MN",14726,13436,1290,8,14232,13453,779,5,14389,13749,640,4,28889,29034,29446,61,257,259,86,374,379,1869,8854,7424,3274
27117,MN,"Pipestone County, MN",4729,4534,195,4,4571,4428,143,3,4662,4544,118,2,9414,9352,9355,38,131,133,25,126,130,528,2270,2179,1275
27119,MN,"Polk County, MN",16446,15502,944,5,16003,15337,666,4,16045,15570,475,3,31083,30817,30731,90,365,373,83,412,403,1521,6329,7537,5692
27121,MN,"Pope County, MN",6607,6308,299,4,6472,6268,204,3,6502,6343,159,2,11326,11418,11431,30,123,121,33,136,139,444,2503,3404,1814
27123,MN,"Ramsey County, MN",291543,271062,20481,7,281195,269271,11924,4,285106,277417,7689,2,551699,542861,536413,1810,6699,6884,1310,4997,5194,33267,74670,98417,161410
27125,MN,"Red Lake County, MN",2251,2104,147,6,2186,2092,94,4,2172,2089,83,3,3940,3932,3874,12,46,48,9,41,37,151,980,1125,485
27127,MN,"Redwood County, MN",7840,7402,438,5,7555,7276,279,3,7596,7395,201,2,15408,15397,15361,56,191,197,42,193,198,741,3916,3768,1992
27129,MN,"Renville County, MN",8569,8071,498,5,8312,7958,354,4,8118,7826,292,3,14697,14628,14525,34,150,156,38,188,200,969,3732,3928,1643
27131,MN,"Rice County, MN",37654,35632,2022,5,37120,35814,1306,3,37472,36502,970,2,67086,67375,67693,184,642,658,151,586,616,3273,14018,12952,12314
27133,MN,"Rock County, MN",5889,5705,184,3,5921,5798,123,2,6010,5909,101,1,9684,9674,9537,19,94,94,37,140,142,366,2056,2402,1672
27135,MN,"Roseau County, MN",7999,7536,463,5,7907,7652,255,3,7952,7749,203,2,15293,15260,15292,35,154,160,45,184,186,689,3788,3882,2091
27137,MN,"St. Louis County, MN",102005,94582,7423,7,99176,94999,4177,4,100261,96982,3279,3,200064,199332,199532,432,1774,1819,581,2402,2495,7360,34695,52182,42732
27139,MN,"Scott County, MN",85537,80460,5077,5,82681,79886,2795,3,84242,82334,1908,2,151350,153408,154520,414,1664,1713,219,893,919,4921,19853,31214,40994
27141,MN,"Sherburne County, MN",53751,50441,3310,6,52044,50029,2015,3,53090,51561,1529,2,97580,99248,100824,300,1152,1184,138,709,729,3615,17393,25878,16349
27143,MN,"Sibley County, MN",8379,7903,476,5,7986,7663,323,4,8078,7819,259,3,14810,14927,14955,45,173,179,32,167,149,763,3960,3879,1762
27145,MN,"Stearns County, MN",92053,86718,5335,5,88710,85172,3538,4,89421,86991,2430,2,158467,159144,160405,536,1949,1998,324,1314,1349,7563,26506,35529,28006
27147,MN,"Steele County, MN",20733,19590,1143,5,20333,19604,729,3,19284,18737,547,2,37375,37409,37398,92,399,412,89,361,378,2101,7511,8530,7034
27149,MN,"Stevens County, MN",5487,5307,180,3,5312,5175,137,2,5349,5232,117,2,9666,9704,9637,36,115,118,16,86,86,378,1853,1922,1638
27151,MN,"Swift County, MN",4923,4633,290,5,4762,4572,190,4,4805,4659,146,3,9804,9781,9755,31,112,114,27,125,120,610,2266,2523,1426
27153,MN,"Todd County, MN",13923,13168,755,5,13422,12875,547,4,13509,13077,432,3,25277,25307,25538,85,300,306,46,229,244,2123,6865,5855,2529
27155,MN,"Traverse County, MN",1772,1692,80,4,1660,1604,56,3,1638,1597,41,2,3361,3287,3275,19,40,45,12,60,63,154,853,993,349
27157,MN,"Wabasha County, MN",12550,11872,678,5,12157,11752,405,3,12165,11849,316,2,21400,21514,21658,60,219,224,62,215,219,860,4989,5428,4124
27159,MN,"Wadena County, MN",6070,5596,474,7,6013,5721,292,4,6068,5817,251,4,14119,14184,14307,57,197,206,44,192,216,871,3236,3669,1559
27161,MN,"Waseca County, MN",9221,8638,583,6,8842,8463,379,4,8618,8318,300,3,18964,18992,18893,50,189,192,39,191,196,945,4572,4683,2956
27163,MN,"Washington County, MN",146471,138162,8309,5,141738,137110,4628,3,144655,141362,3293,2,268372,272610,275912,696,2691,2773,486,2007,2083,6702,34884,53121,84393
27165,MN,"Watonwan County, MN",6721,6405,316,4,6538,6323,215,3,6520,6355,165,2,11231,11158,11075,49,167,172,37,146,147,972,2748,2435,1426
27167,MN,"Wilkin County, MN",3498,3352,146,4,3398,3294,104,3,3395,3319,76,2,6482,6410,6350,13,60,61,31,88,94,266,1549,1691,1010
27169,MN,"Winona County, MN",28513,27087,1426,5,27912,27036,876,3,28246,27630,616,2,49640,49750,49478,133,436,443,120,447,455,2057,7965,11087,9861
27171,MN,"Wright County, MN",77423,73074,4349,5,75043,72443,2600,3,76520,74540,1980,2,141860,145143,148003,452,1770,1829,207,1055,1075,4947,26034,30824,28900
27173,MN,"Yellow Medicine County, MN",5355,5107,248,4,5066,4903,163,3,5036,4894,142,2,9504,9446,9486,26,111,112,19,107,110,515,2227,2722,1212
28000,MS,Mississippi,1247029,1147391,99638,8,1255710,1187096,68614,5,1251022,1201880,49142,3,2958141,2949586,2940057,8503,34972,35060,9743,41379,40014,283522,588217,643438,458928
28001,MS,"Adams County, MS",10462,9328,1134,10,10584,9742,842,8,10527,9984,543,5,29419,28804,28408,78,309,309,130,500,488,4260,7089,5854,3758
28003,MS,"Alcorn County, MS",15156,14216,940,6,15143,14426,717,4,15111,14568,543,3,34727,34429,34204,102,409,408,113,563,546,4606,7596,7229,4804
28005,MS,"Amite County, MS",4388,4024,364,8,4386,4074,312,7,4295,4070,225,5,12699,12644,12619,30,123,123,43,202,198,1358,4019,2936,986
28007,MS,"Attala County, MS",6861,6293,568,8,6862,6455,407,5,6866,6574,292,4,17816,17706,17509,44,215,217,86,327,312,2264,4175,4014,1576
28009,MS,"Benton County, MS",2999,2753,246,8,3041,2849,192,6,3053,2902,151,4,7661,7630,7550,19,80,80,26,148,141,1417,1762,1840,514
28011,MS,"Bolivar County, MS",11384,10406,978,8,11336,10572,764,6,11116,10583,533,4,30827,30180,29370,98,380,383,122,561,546,3998,5030,6164,5190
28013,MS,"Calhoun County, MS",5530,5087,443,8,5451,5169,282,5,5408,5185,223,4,13222,12936,12781,32,155,158,57,272,263,1991,3188,2879,1139
28015,MS,"Carroll County, MS",3400,3140,260,7,3439,3239,200,5,3356,3205,151,4,9930,9817,9731,10,74,74,40,164,159,1424,2539,2331,1084
28017,MS,"Chickasaw County, MS",6888,6152,736,10,6849,6428,421,6,6618,6319,299,4,17078,16973,16812,53,222,224,62,266,261,2671,4039,3259,1423
28019,MS,"Choctaw County, MS",3554,3330,224,6,3564,3394,170,4,3568,3437,131,3,8208,8113,8037,15,75,75,33,143,140,1066,2201,1486,1084
28021,MS,"Claiborne County, MS",3073,2635,438,14,2981,2645,336,11,2904,2666,238,8,9099,8898,8805,19,117,117,32,129,122,931,1495,1561,1077
28023,MS,"Clarke County, MS",5717,5240,477,8,5677,5327,350,6,5610,5346,264,4,15546,15457,15271,52,211,211,74,265,261,1613,4066,3856,1345
28025,MS,"Clay County, MS",7843,6938,905,11,8035,7482,553,6,8692,8334,358,4,18621,18500,18380,51,254,255,71,279,277,2136,4375,3852,2538
28027,MS,"Coahoma County, MS",8289,7269,1020,12,8056,7379,677,8,7552,7127,425,5,21230,20732,20197,67,317,319,94,404,391,2584,3415,5222,2532
28029,MS,"Copiah County, MS",10675,9801,874,8,10791,10106,685,6,10775,10300,475,4,28268,27927,27719,81,319,319,111,429,417,3023,6050,6185,3392
28031,MS,"Covington County, MS",8248,7685,563,6,8226,7808,418,5,8203,7915,288,3,18298,18250,18098,57,267,269,95,359,346,1923,3876,4453,1918
28033,MS,"DeSoto County, MS",91325,85887,5438,6,92984,88922,4062,4,93589,90556,3033,3,186107,189042,191723,544,2152,2152,412,1795,1715,10708,35150,43037,31380
28035,MS,"Forrest County, MS",32519,29922,2597,8,33329,31484,1845,5,33326,32074,1252,3,78185,77883,78110,272,995,999,227,946,913,5338,12421,16723,14043
28037,MS,"Franklin County, MS",2715,2492,223,8,2664,2485,179,6,2632,2491,141,5,7665,7689,7642,26,95,95,35,130,121,875,1623,2012,851
28039,MS,"George County, MS",8879,8079,800,9,8806,8209,597,6,8732,8295,437,5,24364,24793,25206,74,320,321,55,341,329,2416,5486,5839,2172
28041,MS,"Greene County, MS",4261,3851,410,9,4211,3901,310,7,4182,3940,242,5,13530,13643,13552,38,138,139,35,173,165,2222,3492,3067,1067
28043,MS,"Grenada County, MS",9176,8522,654,7,9087,8640,447,4,8811,8481,330,3,21572,21312,21088,55,232,233,90,384,377,2679,4521,4678,3047
28045,MS,"Hancock County, MS",18619,17069,1550,8,19104,18006,1098,5,18982,18208,774,4,46117,46046,46094,105,416,417,144,638,611,3677,9823,11654,7987
28047,MS,"Harrison County, MS",86738,78640,8098,9,87759,83051,4708,5,87332,84025,3307,3,208811,209642,211044,573,2411,2412,579,2510,2406,15165,39204,50036,33822
28049,MS,"Hinds County, MS",102332,92826,9506,9,102062,95905,6157,6,101741,97738,4003,3,226763,222508,217730,682,2808,2816,673,2926,2769,17846,34347,51547,46316
28051,MS,"Holmes County, MS",5459,4584,875,16,5201,4649,552,10,5044,4711,333,6,16879,16476,16121,51,238,238,105,301,291,2453,3874,3229,1385
28053,MS,"Humphreys County, MS",2189,1870,319,14,2063,1812,251,12,1972,1822,150,7,7735,7548,7333,20,85,86,31,146,139,1227,1541,1470,939
28055,MS,"Issaquena County, MS",327,298,29,8,327,298,29,8,314,291,23,7,1325,1297,1273,0,12,12,3,13,13,380,357,160,42
28057,MS,"Itawamba County, MS",10182,9479,703,6,10372,9931,441,4,10261,9910,351,3,23862,23866,23903,66,251,251,84,377,363,2646,5644,5430,2364
28059,MS,"Jackson County, MS",57864,52412,5452,9,58829,55377,3452,5,58527,56036,2491,4,143377,144438,144975,375,1535,1541,390,1730,1665,11074,27711,36820,22530
28061,MS,"Jasper County, MS",5989,5459,530,8,5817,5405,412,7,5834,5540,294,5,16352,16265,16167,51,188,189,69,256,249,1469,4765,3332,1680
28063,MS,"Jefferson County, MS",1965,1608,357,18,1906,1605,301,15,1869,1626,243,13,7249,7156,7087,22,73,73,26,109,112,1052,1613,1338,882
28065,MS,"Jefferson Davis County, MS",3955,3579,376,9,3910,3618,292,7,3876,3681,195,5,11271,11158,11088,21,116,117,37,193,187,1250,3247,2397,1110
28067,MS,"Jones County, MS",25229,23457,1772,7,24634,23252,1382,5,24851,23824,1027,4,67163,66839,66569,210,868,873,228,920,889,6182,14147,14905,9073
28069,MS,"Kemper County, MS",3322,3006,316,9,3284,3046,238,7,3251,3059,192,5,8956,8781,8654,17,80,79,43,141,130,1098,2129,1900,835
28071,MS,"Lafayette County, MS",26356,24770,1586,6,27715,26583,1132,4,28008,27118,890,3,55907,56857,57615,109,513,515,109,518,498,2868,6542,8504,14645
28073,MS,"Lamar County, MS",30462,28646,1816,6,31436,30157,1279,4,31690,30723,967,3,64384,65395,65783,174,751,754,135,570,557,4441,10907,13348,13990
28075,MS,"Lauderdale County, MS",29296,27117,2179,7,29131,27574,1557,5,28832,27664,1168,4,72672,71871,70904,200,839,840,323,1202,1181,7684,13382,18517,10313
28077,MS,"Lawrence County, MS",4617,4220,397,8,4666,4355,311,6,4778,4554,224,4,11982,11774,11713,35,127,127,46,217,213,1490,3137,2304,1219
28079,MS,"Leake County, MS",7952,7333,619,7,7915,7475,440,5,7889,7562,327,4,21245,21247,21135,78,328,328,79,327,326,2661,4995,4104,2311
28081,MS,"Lee County, MS",40932,37642,3290,8,41383,39507,1876,4,40763,39404,1359,3,83310,83043,82959,270,1072,1074,262,1169,1136,7632,14408,17779,15682
28083,MS,"Leflore County, MS",9791,8758,1033,10,9828,9045,783,8,9447,8940,507,5,28191,27398,26570,105,426,424,163,569,559,3090,6396,4888,3322
28085,MS,"Lincoln County, MS",14327,13281,1046,7,14819,14083,736,5,14796,14247,549,3,34822,34907,34717,92,392,392,154,552,543,3477,8994,7513,3860
28087,MS,"Lowndes County, MS",24710,22668,2042,8,24709,23276,1433,5,24553,23542,1011,4,58767,58129,57603,184,717,722,206,818,790,5033,12887,11366,9834
28089,MS,"Madison County, MS",52465,49079,3386,6,52947,50705,2242,4,53338,51667,1671,3,109251,109919,111113,292,1204,1209,301,1214,1186,5610,12197,18039,36177
28091,MS,"Marion County, MS",10016,9311,705,7,10218,9682,536,5,10131,9744,387,3,24370,24271,24050,58,245,246,117,464,450,2749,6286,5874,1899
28093,MS,"Marshall County, MS",14003,12954,1049,7,14219,13404,815,5,14226,13647,579,4,33778,33820,34110,99,420,419,109,526,512,4531,9044,7080,3048
28095,MS,"Monroe County, MS",15509,14145,1364,8,15797,14989,808,5,15582,14963,619,4,34138,33913,33577,116,442,443,146,609,593,4004,9277,6679,4004
28097,MS,"Montgomery County, MS",3871,3563,308,8,3863,3631,232,6,3899,3733,166,4,9796,9704,9530,34,122,122,43,211,206,1545,1886,2234,1256
28099,MS,"Neshoba County, MS",10278,9331,947,9,10020,9461,559,5,9870,9438,432,4,28988,28863,28673,104,428,428,172,559,543,3461,6029,6461,2376
28101,MS,"Newton County, MS",7963,7338,625,7,8184,7743,441,5,7988,7646,342,4,21255,21117,21029,77,300,301,88,328,321,2213,4703,4984,2043
28103,MS,"Noxubee County, MS",3789,3372,417,11,3598,3290,308,8,3400,3197,203,6,10228,10114,9990,45,158,158,48,175,169,1546,2659,1755,827
28105,MS,"Oktibbeha County, MS",21860,20194,1666,7,22345,21124,1221,5,22093,21189,904,4,51698,51808,51427,130,523,523,118,467,448,2458,5696,6858,11828
28107,MS,"Panola County, MS",12592,11372,1220,9,12528,11662,866,6,12333,11757,576,4,33171,32919,32661,130,444,443,109,498,480,4404,7026,7230,3533
28109,MS,"Pearl River County, MS",22988,21343,1645,7,23344,22047,1297,5,23428,22519,909,3,56198,56505,57261,166,591,594,211,876,859,5427,13534,13836,5555
28111,MS,"Perry County, MS",4144,3784,360,8,4248,3975,273,6,4254,4050,204,4,11458,11490,11368,27,120,121,52,218,214,1221,3523,2457,769
28113,MS,"Pike County, MS",14445,13167,1278,8,14361,13364,997,6,14017,13339,678,4,40190,39957,39644,117,500,502,179,638,624,4335,9673,7785,4245
28115,MS,"Pontotoc County, MS",14884,13749,1135,7,15071,14411,660,4,14893,14379,514,3,31194,31336,31389,92,412,412,105,432,423,4325,5834,6749,3512
28117,MS,"Prentiss County, MS",11068,10310,758,6,11290,10799,491,4,11301,10925,376,3,24962,24921,24792,61,268,269,98,411,397,2738,5662,5677,2834
28119,MS,"Quitman County, MS",2337,2087,250,10,2334,2141,193,8,2305,2175,130,5,6154,5911,5701,13,89,90,30,147,142,1094,1472,1257,484
28121,MS,"Rankin County, MS",74462,70573,3889,5,75632,72910,2722,3,76550,74306,2244,2,157149,158183,158979,401,1673,1672,354,1637,1569,11018,25766,37270,34022
28123,MS,"Scott County, MS",12465,11740,725,5,12337,11768,569,4,12242,11809,433,3,27968,27650,27707,130,499,501,89,370,357,3979,6069,5704,2190
28125,MS,"Sharkey County, MS",1456,1299,157,10,1401,1275,126,9,1320,1242,78,5,3769,3648,3488,17,60,60,12,88,89,546,1052,647,460
28127,MS,"Simpson County, MS",10395,9695,700,6,10543,10000,543,5,10592,10192,400,3,25892,25686,25587,67,298,299,88,427,400,3662,5360,5918,2853
28129,MS,"Smith County, MS",6558,6182,376,5,6589,6294,295,4,6616,6373,243,3,14194,14191,14092,39,181,181,46,219,215,1872,3759,2855,1477
28131,MS,"Stone County, MS",6859,6343,516,7,6930,6557,373,5,6955,6666,289,4,18332,18589,18669,45,204,204,62,265,259,1895,4008,4457,1806
28133,MS,"Sunflower County, MS",7458,6638,820,11,7314,6666,648,8,7180,6765,415,5,25853,25328,24811,67,281,281,99,453,440,4287,6072,4645,2874
28135,MS,"Tallahatchie County, MS",5104,4725,379,7,4786,4499,287,6,4631,4435,196,4,12650,12302,12035,31,129,130,46,223,221,1976,3216,2724,1106
28137,MS,"Tate County, MS",11977,11070,907,7,12110,11440,670,5,12125,11650,475,3,28117,28118,28296,77,314,316,90,426,407,2639,6129,6211,3489
28139,MS,"Tippah County, MS",9206,8568,638,6,9440,9009,431,4,9746,9414,332,3,21732,21614,21431,57,254,255,81,343,331,3189,4683,4411,2135
28141,MS,"Tishomingo County, MS",8269,7729,540,6,8325,7948,377,4,8493,8182,311,3,18843,18732,18619,57,187,187,77,382,378,2823,4481,4367,1714
28143,MS,"Tunica County, MS",4447,3782,665,15,4261,3900,361,8,4163,3975,188,4,9723,9652,9458,40,144,144,29,153,150,1033,2604,1819,1021
28145,MS,"Union County, MS",13970,12985,985,7,14137,13570,567,4,14632,14202,430,2,27810,28001,28125,80,344,344,81,372,355,4017,5646,5784,3039
28147,MS,"Walthall County, MS",4931,4519,412,8,4938,4603,335,6,4910,4668,242,4,13868,13804,13761,32,155,155,51,244,242,1674,3492,2364,1654
28149,MS,"Warren County, MS",19962,18241,1721,8,19478,18311,1167,6,19263,18454,809,4,44544,43450,42649,121,490,492,143,687,662,3687,8715,10820,7430
28151,MS,"Washington County, MS",16244,14510,1734,10,15700,14438,1262,8,14729,13881,848,5,44631,43641,42514,140,585,588,174,806,775,5687,9452,8606,6168
28153,MS,"Wayne County, MS",7403,6765,638,8,7301,6819,482,6,7069,6725,344,4,19803,19712,19681,68,287,287,66,264,260,2439,4624,3050,2694
28155,MS,"Webster County, MS",3847,3566,281,7,3916,3706,210,5,3875,3724,151,3,9901,9981,9993,29,126,127,54,169,162,1015,2377,2089,1175
28157,MS,"Wilkinson County, MS",2730,2377,353,12,2746,2452,294,10,2580,2416,164,6,8524,8288,8143,15,80,82,31,157,155,1186,2778,1538,855
28159,MS,"Winston County, MS",7279,6655,624,8,7241,6806,435,6,7138,6827,311,4,17683,17608,17543,51,217,219,58,310,301,1775,4482,4176,1965
28161,MS,"Yalobusha County, MS",4854,4477,377,7,4903,4637,266,5,4749,4555,194,4,12443,12409,12364,36,162,163,65,252,241,1327,4165,2488,1027
28163,MS,"Yazoo County, MS",8992,8083,909,10,8952,8319,633,7,8877,8476,401,4,26671,26432,25948,85,331,333,89,377,363,4737,7128,5522,2323
29000,MO,Missouri,3037880,2851947,185933,6,3050028,2925218,124810,4,3061279,2984340,76939,2,6153998,6169823,6177957,17238,68778,69255,16792,75425,75249,377539,1276601,1248480,1285199
29001,MO,"Adair County, MO",10047,9531,516,5,9825,9425,400,4,9841,9547,294,3,25269,25179,25165,64,275,274,52,274,277,1109,4610,3457,4516
29003,MO,"Andrew County, MO",9711,9319,392,4,9505,9231,274,2,9400,9201,199,2,18098,18009,18003,37,178,178,38,222,209,813,4713,3577,3414
29005,MO,"Atchison County, MO",2714,2604,110,4,2634,2553,81,3,2554,2493,61,2,5308,5227,5182,14,43,48,20,92,97,387,1688,1009,803
29007,MO,"Audrain County, MO",10279,9678,601,5,10144,9791,353,3,9940,9645,295,3,24798,24824,24434,60,287,294,91,376,364,2220,7418,5172,2642
29009,MO,"Barry County, MO",15647,14621,1026,6,14902,14258,644,4,14195,13806,389,2,34541,34733,34926,91,396,400,107,532,507,3629,10080,7028,3634
29011,MO,"Barton County, MO",5155,4901,254,4,5175,5010,165,3,5192,5071,121,2,11608,11649,11694,40,138,138,42,161,165,990,3266,2209,1567
29013,MO,"Bates County, MO",7595,7187,408,5,7638,7333,305,4,7645,7438,207,2,16045,16084,16177,50,183,183,56,232,240,1321,5329,2865,1547
29015,MO,"Benton County, MO",7215,6684,531,7,7255,6866,389,5,7213,6952,261,3,19424,19916,20224,45,153,156,95,381,366,1953,6065,4814,2137
29017,MO,"Bollinger County, MO",5365,5061,304,5,5308,5100,208,3,5285,5147,138,2,10559,10578,10518,30,134,134,38,179,174,1168,3699,1934,920
29019,MO,"Boone County, MO",95846,91739,4107,4,98490,95719,2771,2,99703,97738,1965,2,184035,186075,187690,521,1937,1949,316,1451,1433,5542,23120,28402,53752
29021,MO,"Buchanan County, MO",43592,41434,2158,5,42604,41074,1530,3,42112,41103,1009,2,84460,83655,82911,282,1023,1029,221,1144,1141,6079,22170,16933,12844
29023,MO,"Butler County, MO",18122,16980,1142,6,17877,17083,794,4,17926,17400,526,2,42059,42150,42179,128,541,542,132,706,717,4625,11641,9153,3834
29025,MO,"Caldwell County, MO",4236,4009,227,5,4290,4084,206,4,4251,4134,117,2,8824,8896,8933,25,97,97,21,135,130,647,2697,1765,898
29027,MO,"Callaway County, MO",21370,20410,960,4,21462,20780,682,3,21592,21097,495,2,44337,44667,44762,140,455,458,121,518,513,3321,11086,8848,7353
29029,MO,"Camden County, MO",18742,17432,1310,7,19103,18214,889,4,19079,18481,598,3,42802,43527,43768,89,361,362,139,660,670,2817,11953,10562,7314
29031,MO,"Cape Girardeau County, MO",40378,38300,2078,5,40150,38791,1359,3,40390,39491,899,2,81811,82147,82899,234,884,891,233,1031,1005,4250,16792,14070,17102
29033,MO,"Carroll County, MO",4611,4355,256,5,4481,4297,184,4,4391,4276,115,2,8468,8403,8423,18,88,90,22,131,123,576,2674,1556,1175
29035,MO,"Carter County, MO",2519,2354,165,6,2543,2419,124,4,2494,2405,89,3,5202,5339,5268,15,87,87,22,94,96,478,1910,796,483
29037,MO,"Cass County, MO",53832,50948,2884,5,54378,52392,1986,3,55021,53705,1316,2,108145,109751,110394,297,1130,1137,256,1209,1212,4884,23709,24677,19923
29039,MO,"Cedar County, MO",5719,5462,257,4,5747,5547,200,3,5638,5485,153,2,14210,14518,14601,50,192,192,42,210,223,1359,3857,3089,1516
29041,MO,"Chariton County, MO",3734,3583,151,4,3717,3601,116,3,3681,3605,76,2,7384,7361,7386,21,76,76,25,134,130,452,2430,1338,1006
29043,MO,"Christian County, MO",45611,43368,2243,4,46565,45155,1410,3,47463,46497,966,2,89284,91541,93114,227,1010,1032,166,957,930,4443,17079,19062,18634
29045,MO,"Clark County, MO",3157,2966,191,6,3102,2965,137,4,2998,2903,95,3,6661,6738,6723,25,82,81,10,106,102,621,2053,1336,563
29047,MO,"Clay County, MO",136422,128083,8339,6,138246,131866,6380,4,138929,135472,3457,2,254112,255860,257033,736,2957,2971,464,2272,2279,10957,46008,54904,58040
29049,MO,"Clinton County, MO",10499,9875,624,5,10648,10116,532,5,10634,10334,300,2,21210,21258,21328,67,233,234,65,286,290,974,6330,4218,3114
29051,MO,"Cole County, MO",38765,37045,1720,4,38912,37784,1128,2,39196,38428,768,2,76614,76631,76969,195,821,832,159,863,823,3981,15884,14761,18899
29053,MO,"Cooper County, MO",7155,6763,392,5,7051,6810,241,3,7070,6901,169,2,16648,16672,16772,47,181,186,47,214,214,1268,4517,3300,2756
29055,MO,"Crawford County, MO",10790,10097,693,6,10855,10393,462,4,10773,10469,304,2,23037,22818,22659,56,230,232,77,373,382,3074,6365,4876,1952
29057,MO,"Dade County, MO",3548,3394,154,4,3526,3415,111,3,3447,3372,75,2,7587,7600,7660,16,69,66,19,138,136,592,2400,1743,760
29059,MO,"Dallas County, MO",7077,6661,416,5,7169,6878,291,4,7219,7025,194,2,17130,17371,17626,64,216,218,63,309,302,1538,5666,2957,1524
29061,MO,"Daviess County, MO",4105,3931,174,4,4082,3936,146,3,3960,3864,96,2,8425,8385,8435,26,112,113,24,115,115,718,2286,1471,1120
29063,MO,"DeKalb County, MO",4202,4012,190,4,4104,3955,149,3,4029,3925,104,2,11610,11708,11336,24,96,96,31,149,143,892,3965,2387,1312
29065,MO,"Dent County, MO",6298,5993,305,4,6240,5987,253,4,6095,5905,190,3,14389,14428,14467,34,148,147,66,268,270,1659,4246,2766,1602
29067,MO,"Douglas County, MO",5137,4742,395,7,5117,4910,207,4,5142,5003,139,2,11604,11754,11975,38,138,139,42,211,223,1376,3431,2545,1118
29069,MO,"Dunklin County, MO",11518,10673,845,7,11168,10533,635,5,10927,10486,441,4,28217,27751,27406,90,372,366,111,559,557,3932,7676,4676,2622
29071,MO,"Franklin County, MO",52549,49291,3258,6,52596,50628,1968,3,53012,51787,1225,2,104853,105328,105879,268,1102,1108,278,1335,1338,7286,24440,25430,15321
29073,MO,"Gasconade County, MO",7586,7149,437,5,7566,7306,260,3,7590,7418,172,2,14760,14791,14768,28,142,148,57,263,267,1251,4298,3242,1943
29075,MO,"Gentry County, MO",3391,3276,115,3,3303,3220,83,2,3178,3110,68,2,6134,6169,6253,19,71,73,34,110,106,593,1783,1027,843
29077,MO,"Greene County, MO",149610,141530,8080,5,152233,147367,4866,3,155126,151957,3169,2,299312,301118,303293,791,3232,3250,726,3579,3559,13820,54625,64193,61976
29079,MO,"Grundy County, MO",4276,4079,197,4,4154,4013,141,3,4028,3922,106,2,9761,9761,9838,30,126,123,36,152,153,1030,2461,2055,1076
29081,MO,"Harrison County, MO",3785,3612,173,4,3726,3601,125,3,3693,3604,89,2,8156,8170,8199,21,90,90,26,122,121,488,2575,1643,939
29083,MO,"Henry County, MO",9646,9075,571,5,9972,9598,374,3,10153,9889,264,2,21974,22221,22438,57,255,259,72,356,357,1783,6663,4737,2448
29085,MO,"Hickory County, MO",3865,3670,195,5,3921,3773,148,3,4011,3901,110,2,8301,8594,8630,20,87,96,33,168,185,707,3115,2043,640
29087,MO,"Holt County, MO",2539,2453,86,3,2468,2399,69,2,2423,2378,45,1,4184,4241,4262,4,43,44,14,75,75,184,1469,839,657
29089,MO,"Howard County, MO",4804,4603,201,4,4815,4667,148,3,4720,4607,113,2,10151,10128,10168,30,95,96,30,128,127,798,2255,1716,1829
29091,MO,"Howell County, MO",16191,15100,1091,6,16012,15287,725,4,15896,15428,468,2,39793,39980,40631,114,458,462,137,650,647,3843,10653,7717,4943
29093,MO,"Iron County, MO",3487,3239,248,7,3457,3268,189,5,3459,3321,138,4,9514,9421,9414,18,92,92,47,188,188,1197,2714,1924,1075
29095,MO,"Jackson County, MO",356799,330907,25892,7,359128,340899,18229,5,360551,350264,10287,2,717572,717616,716531,2230,8511,8552,1835,7932,7837,41977,136438,150265,157512
29097,MO,"Jasper County, MO",55795,52603,3192,5,56472,54480,1992,3,56822,55500,1322,2,122878,123325,124075,384,1529,1543,318,1543,1549,9967,27173,24064,19258
29099,MO,"Jefferson County, MO",116718,109597,7121,6,117211,112771,4440,3,118310,115524,2786,2,226927,227934,229336,626,2378,2399,582,2587,2537,14532,49883,57838,34682
29101,MO,"Johnson County, MO",23060,21745,1315,5,22883,21930,953,4,22795,22192,603,2,54018,54170,54368,193,681,681,119,539,540,2228,9840,10336,9218
29103,MO,"Knox County, MO",1745,1675,70,4,1720,1669,51,3,1689,1645,44,2,3739,3787,3776,14,44,44,12,60,61,328,1120,639,379
29105,MO,"Laclede County, MO",16714,15338,1376,8,16372,15707,665,4,16510,16093,417,2,36044,36135,36313,103,456,459,105,541,543,3263,10256,6660,4039
29107,MO,"Lafayette County, MO",16500,15630,870,5,16662,15995,667,4,16764,16324,440,2,33062,32832,32961,92,352,349,88,475,468,2181,9885,5813,4889
29109,MO,"Lawrence County, MO",17621,16544,1077,6,17309,16647,662,3,17057,16641,416,2,37977,38268,38683,127,486,492,105,575,579,3777,9885,7703,3861
29111,MO,"Lewis County, MO",4934,4691,243,4,4798,4639,159,3,4729,4620,109,2,10039,9986,9891,23,89,91,26,138,143,962,2979,1808,838
29113,MO,"Lincoln County, MO",29030,27242,1788,6,29211,27950,1261,4,29329,28562,767,2,59849,61654,63155,178,766,773,122,589,596,3596,15996,12335,7370
29115,MO,"Linn County, MO",5048,4735,313,6,5036,4777,259,5,5097,4947,150,2,11852,11843,11820,28,131,134,36,198,196,828,3776,2036,1566
29117,MO,"Livingston County, MO",7289,7016,273,3,7194,6989,205,2,7181,7039,142,2,13988,14223,14402,38,170,172,33,208,216,1238,4355,2825,2102
29119,MO,"McDonald County, MO",10493,9961,532,5,10713,10331,382,3,11061,10792,269,2,23286,23428,23588,78,322,326,72,313,304,3397,6768,3693,1700
29121,MO,"Macon County, MO",7417,7060,357,4,7289,7034,255,3,7168,6987,181,2,15197,15167,15049,38,175,174,57,260,253,1010,4756,2830,1855
29123,MO,"Madison County, MO",5453,5096,357,6,5418,5192,226,4,5366,5211,155,2,12626,12671,12753,20,130,132,36,214,217,1091,3643,2640,1374
29125,MO,"Maries County, MO",3895,3705,190,4,3878,3737,141,3,3833,3736,97,2,8452,8422,8431,34,97,99,29,151,147,857,2371,1804,1033
29127,MO,"Marion County, MO",14227,13539,688,4,14075,13614,461,3,13731,13407,324,2,28480,28502,28438,68,312,324,80,393,394,1999,7041,5532,4677
29129,MO,"Mercer County, MO",1862,1796,66,3,1792,1741,51,2,1686,1645,41,2,3513,3469,3437,13,45,44,20,66,64,305,1042,644,448
29131,MO,"Miller County, MO",12271,11522,749,6,12514,12029,485,3,12714,12392,322,2,24770,24943,25403,74,303,305,74,356,363,1869,6666,5115,3344
29133,MO,"Mississippi County, MO",5628,5326,302,5,5376,5141,235,4,5158,4994,164,3,12130,12129,11688,37,138,141,40,222,221,1849,4303,1783,1223
29135,MO,"Moniteau County, MO",7100,6793,307,4,7089,6864,225,3,7072,6912,160,2,15213,15284,15220,50,187,188,51,193,195,1523,4475,2632,1933
29137,MO,"Monroe County, MO",3776,3552,224,5,3762,3608,154,4,3733,3633,100,2,8686,8720,8652,24,95,95,19,127,124,557,2966,1605,963
29139,MO,"Montgomery County, MO",5707,5424,283,5,5758,5556,202,3,5816,5675,141,2,11287,11429,11470,40,127,129,40,202,198,1134,3507,2056,1313
29141,MO,"Morgan County, MO",8204,7689,515,6,8397,8020,377,4,8287,8041,246,3,20990,21417,21785,54,261,262,80,336,336,3067,5913,3779,1925
29143,MO,"New Madrid County, MO",8398,7906,492,5,8254,7887,367,4,8096,7855,241,3,16331,16024,15695,42,199,200,72,331,324,2036,5223,2657,1575
29145,MO,"Newton County, MO",26585,25035,1550,5,26817,25854,963,3,26914,26262,652,2,58684,59437,60011,168,663,669,156,777,810,4288,13968,12627,8979
29147,MO,"Nodaway County, MO",10708,10229,479,4,10658,10357,301,2,10893,10654,239,2,21000,20984,20670,64,218,218,34,200,197,729,4654,3414,3258
29149,MO,"Oregon County, MO",3912,3645,267,6,3806,3617,189,5,3757,3639,118,3,8611,8639,8732,24,108,110,40,171,174,1037,2733,1577,887
29151,MO,"Osage County, MO",7015,6761,254,3,7028,6854,174,2,7050,6915,135,1,13265,13409,13399,32,145,147,30,153,157,743,3821,2573,1981
29153,MO,"Ozark County, MO",3464,3212,252,7,3415,3240,175,5,3392,3266,126,3,8520,8774,8940,9,69,72,44,175,175,1200,2655,1878,772
29155,MO,"Pemiscot County, MO",6260,5757,503,8,5979,5574,405,6,5741,5523,218,3,15585,15225,14841,53,221,224,73,302,303,2118,4804,2333,1231
29157,MO,"Perry County, MO",9812,9264,548,5,9721,9430,291,3,9549,9350,199,2,18969,18956,18858,45,208,210,43,257,246,1801,5319,3418,2512
29159,MO,"Pettis County, MO",20581,19178,1403,6,20144,19254,890,4,19985,19472,513,2,43001,43206,43353,149,568,579,117,577,563,3576,9988,9618,5178
29161,MO,"Phelps County, MO",19726,18782,944,4,19848,19148,700,3,19987,19494,493,2,44560,44949,45313,98,406,409,113,594,592,2629,8411,8196,8729
29163,MO,"Pike County, MO",7459,7055,404,5,7322,7050,272,3,7225,7045,180,2,17408,17602,17664,46,205,206,49,223,226,1617,6468,2550,1858
29165,MO,"Platte County, MO",58761,55563,3198,5,59445,57187,2258,3,60049,58738,1311,2,107168,108720,110534,296,1191,1200,181,908,921,2428,15714,21921,31960
29167,MO,"Polk County, MO",14290,13615,675,4,14570,14092,478,3,14744,14386,358,2,31612,32089,32693,95,380,380,81,428,428,2190,7620,6140,4405
29169,MO,"Pulaski County, MO",14526,13701,825,5,14432,13826,606,4,14517,14089,428,2,54017,53850,53941,177,718,722,90,438,435,1667,8972,10610,8714
29171,MO,"Putnam County, MO",2266,2166,100,4,2219,2152,67,3,2162,2112,50,2,4690,4696,4666,12,58,57,8,78,88,192,1404,1185,639
29173,MO,"Ralls County, MO",5611,5360,251,4,5556,5376,180,3,5405,5280,125,2,10357,10378,10420,28,100,100,32,148,142,699,3594,1969,1061
29175,MO,"Randolph County, MO",10121,9518,603,6,10184,9779,405,4,10191,9931,260,2,24454,24569,24622,60,261,268,59,355,356,1884,6574,5540,3117
29177,MO,"Ray County, MO",10761,10020,741,6,10965,10295,670,6,10910,10546,364,3,23129,23061,23107,63,260,260,80,348,355,1713,7353,4566,2489
29179,MO,"Reynolds County, MO",2922,2757,165,5,2905,2792,113,3,2803,2722,81,2,6077,6082,6006,19,65,66,23,101,105,1014,1738,1195,626
29181,MO,"Ripley County, MO",5009,4614,395,7,5033,4774,259,5,5042,4883,159,3,10670,10619,10703,34,148,147,51,226,234,1400,3131,2356,794
29183,MO,"St. Charles County, MO",225255,213513,11742,5,226793,219432,7361,3,229549,224834,4715,2,406385,410511,413803,1034,4118,4139,878,3801,3791,12718,63606,83913,115046
29185,MO,"St. Clair County, MO",3774,3539,235,6,3805,3644,161,4,3786,3676,110,2,9351,9404,9576,19,106,110,34,164,160,809,2837,2231,908
29186,MO,"Ste. Genevieve County, MO",9188,8733,455,5,9176,8879,297,3,9267,9058,209,2,18474,18571,18644,48,196,197,47,227,230,1130,4927,4583,2502
29187,MO,"St. Francois County, MO",26256,24405,1851,7,25780,24609,1171,4,25566,24735,831,3,66437,67057,66969,168,682,684,179,1028,1023,6683,18093,15922,6949
29189,MO,"St. Louis County, MO",521500,488389,33111,6,524264,502337,21927,4,527524,514653,12871,2,1003056,998227,990414,2600,10460,10526,3241,12173,12158,41053,146718,192739,315016
29195,MO,"Saline County, MO",10560,10077,483,4,10350,10004,346,3,10237,9984,253,2,23323,23241,23007,64,249,249,62,330,336,1960,5822,3693,3708
29197,MO,"Schuyler County, MO",1898,1787,111,5,1830,1755,75,4,1801,1747,54,3,4010,4021,4002,16,66,64,15,61,64,280,1322,849,263
29199,MO,"Scotland County, MO",2376,2298,78,3,2308,2250,58,2,2258,2210,48,2,4699,4679,4643,23,82,83,13,65,67,614,1223,712,436
29201,MO,"Scott County, MO",19850,18790,1060,5,20040,19308,732,3,19920,19446,474,2,38020,37856,37840,109,477,479,127,583,581,3739,9829,7099,5261
29203,MO,"Shannon County, MO",3345,3102,243,7,3335,3159,176,5,3266,3147,119,3,7028,7085,7193,12,80,79,22,139,137,735,2396,1242,788
29205,MO,"Shelby County, MO",3029,2893,136,4,2970,2877,93,3,2931,2863,68,2,6088,5957,5982,14,62,63,27,97,95,474,1774,1152,794
29207,MO,"Stoddard County, MO",13188,12411,777,5,13213,12658,555,4,13052,12673,379,2,28644,28482,28377,77,339,341,111,461,457,3804,8741,4825,2742
29209,MO,"Stone County, MO",13157,11891,1266,9,13435,12607,828,6,13346,12844,502,3,31206,31605,32136,66,273,275,99,475,489,2394,8150,8538,4981
29211,MO,"Sullivan County, MO",2752,2633,119,4,2632,2512,120,4,2520,2450,70,2,5987,5916,5840,19,67,66,18,85,86,617,1986,901,624
29213,MO,"Taney County, MO",25992,22675,3317,12,25903,24089,1814,7,25648,24616,1032,4,56057,56334,56821,142,579,585,161,754,779,3849,13331,12936,8648
29215,MO,"Texas County, MO",8939,8421,518,5,8952,8569,383,4,8993,8726,267,3,24326,24893,25336,70,272,282,82,405,420,2626,7101,5323,2619
29217,MO,"Vernon County, MO",9389,8975,414,4,9316,9015,301,3,9066,8839,227,2,19669,19605,19651,72,253,255,53,309,319,1410,5320,3974,2523
29219,MO,"Warren County, MO",18541,17482,1059,5,18666,17942,724,3,18801,18335,466,2,35740,36529,37260,87,400,402,84,444,433,2920,9183,7389,4749
29221,MO,"Washington County, MO",10079,9353,726,7,10027,9546,481,4,10059,9738,321,3,23416,23444,23441,69,266,265,70,374,392,3226,6687,4535,2087
29223,MO,"Wayne County, MO",5018,4709,309,6,4822,4596,226,4,4731,4563,168,3,10933,10907,10792,28,109,110,55,233,238,1505,3548,2318,886
29225,MO,"Webster County, MO",17199,16277,922,5,17407,16846,561,3,17627,17241,386,2,39002,39580,40335,145,574,573,83,489,489,3198,9724,7673,4624
29227,MO,"Worth County, MO",1170,1122,48,4,1167,1139,28,2,1138,1116,22,1,1962,1969,1955,9,21,21,6,30,31,121,693,334,258
29229,MO,"Wright County, MO",7378,6863,515,7,7551,7264,287,3,7549,7343,206,2,18211,18640,19156,57,232,234,38,256,285,2065,5193,3451,1415
29510,MO,"St. Louis city, MO",150138,137017,13121,8,149707,140933,8774,5,149069,144444,4625,3,300483,293562,286578,914,3723,3752,1009,3616,3596,23488,53352,58568,83019
30000,MT,Montana,545334,513545,31789,5,550555,531926,18629,3,567787,552842,14945,2,1087075,1106227,1122867,2812,10806,11173,2527,12115,12859,42160,207496,245580,251226
30001,MT,"Beaverhead County, MT",5110,4907,203,4,5150,5006,144,2,5378,5253,125,2,9381,9532,9719,17,75,76,18,123,130,348,1787,2123,2110
30003,MT,"Big Horn County, MT",4890,4537,353,7,4694,4340,354,7,4716,4509,207,4,13082,12932,12851,56,200,207,40,220,238,789,2521,2683,1447
30005,MT,"Blaine County, MT",2280,2172,108,4,2244,2157,87,3,2223,2153,70,3,7005,6982,6936,24,91,92,18,94,100,394,1127,1664,1044
30007,MT,"Broadwater County, MT",2662,2496,166,6,2676,2569,107,4,2798,2704,94,3,6857,7323,7793,25,66,69,8,57,57,336,1257,2030,1115
30009,MT,"Carbon County, MT",5663,5330,333,5,5662,5467,195,3,5792,5639,153,2,10510,10862,11179,12,73,76,36,132,137,361,2433,2709,2535
30011,MT,"Carter County, MT",650,632,18,2,654,637,17,2,680,666,14,2,1408,1410,1382,1,10,10,4,23,24,79,320,414,214
30013,MT,"Cascade County, MT",38080,35854,2226,5,37898,36639,1259,3,39224,38192,1032,2,84402,84498,84864,233,899,936,202,1084,1151,4058,18023,19560,15973
30015,MT,"Chouteau County, MT",2483,2388,95,3,2467,2399,68,2,2490,2433,57,2,5895,5916,5898,12,40,41,24,67,74,325,1427,1230,1120
30017,MT,"Custer County, MT",6253,5954,299,4,6268,6075,193,3,6415,6259,156,2,11863,11971,12032,30,108,111,30,138,143,507,2544,3113,2393
30019,MT,"Daniels County, MT",894,869,25,2,873,856,17,1,884,867,17,1,1653,1669,1628,2,10,10,5,28,31,92,460,459,290
30021,MT,"Dawson County, MT",4693,4435,258,5,4529,4388,141,3,4572,4466,106,2,8923,8866,8830,20,89,93,21,135,139,328,1976,2719,1516
30023,MT,"Deer Lodge County, MT",5095,4838,257,5,5135,4968,167,3,5409,5276,133,2,9420,9506,9510,14,70,72,35,150,152,685,2770,2264,1661
30025,MT,"Fallon County, MT",1658,1593,65,3,1625,1583,42,2,1663,1637,26,1,3028,2984,3011,3,22,22,10,40,42,94,713,875,400
30027,MT,"Fergus County, MT",5871,5607,264,4,5847,5654,193,3,5937,5769,168,2,11469,11609,11663,29,115,118,32,182,189,399,2739,3138,2250
30029,MT,"Flathead County, MT",49971,46107,3864,7,51074,49012,2062,4,52636,51020,1616,3,104862,108725,111814,281,1076,1112,255,1162,1238,3729,20566,24647,24821
30031,MT,"Gallatin County, MT",71221,67672,3549,5,74131,72341,1790,2,77887,76435,1452,1,119585,123051,124857,287,1142,1183,134,635,672,1919,13764,20226,39236
30033,MT,"Garfield County, MT",749,729,20,2,745,727,18,2,760,738,22,2,1170,1210,1218,4,15,15,3,13,15,16,279,231,144
30035,MT,"Glacier County, MT",5535,5001,534,9,5545,5167,378,6,5776,5490,286,5,13737,13743,13681,45,186,194,42,187,196,965,3135,2504,1831
30037,MT,"Golden Valley County, MT",366,349,17,4,370,357,13,3,376,364,12,3,821,818,835,2,9,9,5,15,17,53,234,220,121
30039,MT,"Granite County, MT",1607,1478,129,8,1633,1560,73,4,1670,1606,64,3,3308,3355,3502,7,27,27,7,30,30,225,702,745,815
30041,MT,"Hill County, MT",7645,7269,376,4,7561,7324,237,3,7580,7394,186,2,16263,16175,16068,53,210,218,36,188,203,893,3042,3534,2635
30043,MT,"Jefferson County, MT",5855,5559,296,5,5915,5722,193,3,6118,5963,155,2,12140,12472,12826,34,94,98,34,154,162,480,2331,2820,3137
30045,MT,"Judith Basin County, MT",989,942,47,4,948,922,26,2,981,957,24,2,2025,2052,2105,9,24,25,2,16,17,72,423,597,330
30047,MT,"Lake County, MT",13804,12957,847,6,14027,13490,537,3,14381,13945,436,3,31246,32075,32853,72,287,294,82,353,375,1644,5412,7400,6975
30049,MT,"Lewis and Clark County, MT",36902,35087,1815,4,37303,36188,1115,3,38748,37830,918,2,71168,72503,73832,200,694,720,171,724,743,2164,11523,14920,20943
30051,MT,"Liberty County, MT",977,950,27,2,986,963,23,2,983,960,23,2,1956,1934,1972,4,25,27,3,21,25,386,281,423,320
30053,MT,"Lincoln County, MT",8153,7336,817,10,8179,7700,479,5,8684,8270,414,4,19739,20571,21525,34,146,151,64,297,316,1288,5771,5213,2900
30055,MT,"McCone County, MT",963,936,27,2,975,957,18,1,978,960,18,1,1730,1711,1709,3,14,14,2,14,17,53,426,623,245
30057,MT,"Madison County, MT",4705,4471,234,5,4799,4647,152,3,5234,5118,116,2,8660,8944,9265,15,58,60,32,109,111,243,1890,2457,2152
30059,MT,"Meagher County, MT",964,919,45,4,991,966,25,2,1016,993,23,2,1922,1960,2013,5,15,15,7,20,25,52,477,476,422
30061,MT,"Mineral County, MT",1796,1616,180,10,1878,1778,100,5,1863,1768,95,5,4565,4868,5058,13,40,41,14,64,67,255,1158,1151,857
30063,MT,"Missoula County, MT",64821,60791,4030,6,65056,62859,2197,3,66910,65147,1763,2,118337,119806,121041,271,1074,1111,211,1000,1088,2918,16601,25009,35295
30065,MT,"Musselshell County, MT",2350,2208,142,6,2353,2254,99,4,2356,2288,68,2,4745,4912,5197,9,45,46,15,72,78,314,1274,1289,758
30067,MT,"Park County, MT",9050,8385,665,7,9274,8945,329,3,10039,9766,273,2,17224,17531,17790,37,143,147,54,202,202,453,3586,4787,4405
30069,MT,"Petroleum County, MT",272,263,9,3,272,264,8,2,271,263,8,3,500,522,524,3,7,7,1,5,5,2,137,99,94
30071,MT,"Phillips County, MT",1903,1811,92,4,1854,1784,70,3,1829,1762,67,3,4208,4216,4240,15,45,46,13,52,57,223,1059,1158,574
30073,MT,"Pondera County, MT",2683,2553,130,4,2643,2558,85,3,2631,2563,68,2,5879,6018,6078,12,64,65,17,67,74,355,1200,1617,931
30075,MT,"Powder River County, MT",969,939,30,3,982,956,26,2,1004,982,22,2,1693,1707,1725,4,15,15,3,20,22,80,418,475,325
30077,MT,"Powell County, MT",2940,2804,136,4,2965,2887,78,2,2959,2881,78,2,6941,7012,7051,12,43,43,17,90,97,532,2293,1576,1018
30079,MT,"Prairie County, MT",474,442,32,6,492,474,18,3,496,481,15,3,1093,1101,1107,4,8,8,3,19,21,119,263,296,234
30081,MT,"Ravalli County, MT",20936,19741,1195,5,21363,20590,773,3,21908,21286,622,2,44409,46125,47298,101,377,390,116,566,593,2425,9763,11291,9305
30083,MT,"Richland County, MT",5995,5612,383,6,5870,5636,234,4,5826,5673,153,2,11531,11342,11237,45,159,163,19,115,122,348,2928,3041,1225
30085,MT,"Roosevelt County, MT",4470,4204,266,6,4348,4165,183,4,4365,4214,151,3,10794,10808,10572,52,187,190,30,209,217,598,2021,2401,1210
30087,MT,"Rosebud County, MT",3758,3548,210,5,3593,3450,143,4,3625,3500,125,3,8305,8077,8088,33,121,125,30,148,152,556,1740,1966,1020
30089,MT,"Sanders County, MT",5112,4718,394,7,5235,4983,252,4,5426,5193,233,4,12463,12975,13442,23,91,94,33,188,196,849,3703,3117,1796
30091,MT,"Sheridan County, MT",1772,1687,85,4,1787,1728,59,3,1765,1731,34,1,3536,3569,3564,11,31,31,6,38,43,188,890,810,653
30093,MT,"Silver Bow County, MT",17445,16305,1140,6,17553,16915,638,3,17882,17366,516,2,35201,35554,36068,85,330,343,99,476,497,1503,8313,7536,6738
30095,MT,"Stillwater County, MT",5398,5127,271,5,5506,5347,159,2,5469,5346,123,2,8997,9026,9177,11,70,74,23,107,114,469,2062,2106,1799
30097,MT,"Sweet Grass County, MT",1866,1800,66,3,1906,1861,45,2,1924,1885,39,2,3670,3705,3715,8,21,21,11,52,58,102,842,1071,572
30099,MT,"Teton County, MT",2803,2683,120,4,2811,2722,89,3,2809,2734,75,2,6256,6282,6368,23,69,71,20,81,86,315,1436,1372,1051
30101,MT,"Toole County, MT",2160,2054,106,4,2057,2003,54,2,2103,2061,42,2,4970,5010,5082,16,47,47,13,51,62,376,1259,1000,933
30103,MT,"Treasure County, MT",342,330,12,3,349,339,10,2,350,343,7,2,758,769,758,5,12,12,2,9,10,49,184,155,161
30105,MT,"Valley County, MT",4100,3925,175,4,4035,3908,127,3,4013,3913,100,2,7556,7556,7513,15,65,67,22,97,105,372,1766,2160,1013
30107,MT,"Wheatland County, MT",766,712,54,7,759,720,39,5,756,728,28,3,2083,2045,2032,4,17,17,11,34,35,147,611,520,277
30109,MT,"Wibaux County, MT",453,430,23,5,428,413,15,3,450,439,11,2,937,935,919,4,9,9,3,24,27,53,280,213,174
30111,MT,"Yellowstone County, MT",84020,79486,4534,5,84284,81608,2676,3,86774,84667,2107,2,165196,167397,169852,463,1826,1895,379,1918,2062,5582,31356,37347,37713
31000,NE,Nebraska,1048389,1003443,44946,4,1049584,1021330,28254,2,1058927,1034091,24836,2,1962642,1963554,1967923,6046,24260,24376,4472,19535,19271,105606,326345,423189,420175
31001,NE,"Adams County, NE",17091,16397,694,4,16979,16545,434,2,17316,16930,386,2,31177,30990,30970,97,372,369,97,381,378,1717,5533,7857,5266
31003,NE,"Antelope County, NE",3944,3855,89,2,3690,3624,66,1,3689,3618,71,1,6278,6292,6293,27,91,89,22,92,92,332,1543,1653,796
31005,NE,"Arthur County, NE",234,222,12,5,236,229,7,3,234,229,5,2,432,441,433,1,5,2,1,3,3,14,77,139,90
31007,NE,"Banner County, NE",394,382,12,3,389,380,9,2,391,379,12,3,677,689,660,2,9,9,3,5,5,34,84,223,128
31009,NE,"Blaine County, NE",256,247,9,3,249,242,7,2,253,243,10,4,431,461,453,0,2,6,2,6,6,23,105,95,66
31011,NE,"Boone County, NE",2963,2887,76,2,2954,2903,51,1,3040,2984,56,1,5359,5400,5385,19,63,63,15,74,74,194,1507,1315,732
31013,NE,"Box Butte County, NE",5426,5165,261,4,5484,5339,145,2,5355,5227,128,2,10826,10647,10672,36,113,113,30,134,135,707,2404,2956,1399
31015,NE,"Boyd County, NE",1061,1030,31,2,1034,1012,22,2,1040,1016,24,2,1805,1786,1741,5,15,15,11,36,37,67,592,472,229
31017,NE,"Brown County, NE",1426,1386,40,2,1434,1399,35,2,1440,1402,38,2,2902,2912,2872,10,37,38,15,51,54,128,755,703,460
31019,NE,"Buffalo County, NE",27954,26821,1133,4,28135,27529,606,2,28488,27922,566,2,50195,50310,50586,172,627,630,92,460,441,2373,7597,10198,10636
31021,NE,"Burt County, NE",3607,3465,142,3,3611,3516,95,2,3598,3513,85,2,6721,6706,6755,15,70,71,26,108,108,421,1707,1494,1088
31023,NE,"Butler County, NE",4639,4479,160,3,4702,4592,110,2,4748,4661,87,1,8345,8425,8427,17,101,104,26,104,104,359,2116,1898,1367
31025,NE,"Cass County, NE",13524,12925,599,4,13568,13179,389,2,13726,13389,337,2,26601,27071,27122,57,264,267,69,302,295,1037,5208,6560,5427
31027,NE,"Cedar County, NE",4577,4451,126,2,4660,4570,90,1,4681,4592,89,1,8372,8325,8371,24,110,109,27,103,100,321,2099,1978,1222
31029,NE,"Chase County, NE",2295,2254,41,1,2252,2213,39,1,2292,2250,42,1,3887,3829,3772,20,49,52,11,58,58,311,674,1009,576
31031,NE,"Cherry County, NE",3410,3325,85,2,3467,3409,58,1,3403,3342,61,1,5454,5447,5464,12,76,75,15,79,82,104,1223,1496,982
31033,NE,"Cheyenne County, NE",4303,4110,193,4,4264,4136,128,3,4266,4158,108,2,9486,9502,9511,20,91,92,29,127,123,417,2232,2511,1505
31035,NE,"Clay County, NE",3314,3204,110,3,3265,3184,81,2,3129,3055,74,2,6105,6047,6049,15,74,77,14,91,88,294,1487,1564,838
31037,NE,"Colfax County, NE",5694,5527,167,2,5721,5603,118,2,5781,5667,114,2,10557,10474,10444,55,179,179,20,79,79,1723,1938,1843,981
31039,NE,"Cuming County, NE",4905,4779,126,2,4935,4846,89,1,4908,4814,94,1,9008,8972,8929,20,114,118,21,123,117,654,2114,1934,1453
31041,NE,"Custer County, NE",6448,6270,178,2,6413,6303,110,1,6405,6295,110,1,10493,10476,10476,24,110,111,36,144,138,409,2380,2827,1721
31043,NE,"Dakota County, NE",10758,10233,525,4,10842,10488,354,3,11067,10753,314,2,21552,21256,21042,95,346,343,71,236,237,2855,4336,3963,1784
31045,NE,"Dawes County, NE",5001,4860,141,2,5025,4922,103,2,5034,4927,107,2,8150,8131,8241,24,83,84,26,106,104,259,1055,1923,1855
31047,NE,"Dawson County, NE",13495,13027,468,3,13568,13257,311,2,13733,13396,337,2,24086,23934,23884,107,368,370,61,262,261,3464,4811,4765,2510
31049,NE,"Deuel County, NE",970,939,31,3,978,956,22,2,1036,1011,25,2,1831,1857,1902,4,16,14,3,23,24,131,405,569,268
31051,NE,"Dixon County, NE",2967,2868,99,3,2989,2920,69,2,3056,2990,66,2,5582,5546,5464,18,59,60,20,74,74,589,1231,1157,803
31053,NE,"Dodge County, NE",20373,19648,725,3,20501,19986,515,2,20844,20392,452,2,37110,37120,36997,113,456,462,124,523,522,2661,8946,8242,4881
31055,NE,"Douglas County, NE",303610,287965,15645,5,303668,293892,9776,3,306992,298826,8166,2,585386,585467,586327,1965,7839,7866,1188,4917,4838,33257,78693,111841,153885
31057,NE,"Dundy County, NE",1171,1145,26,2,1167,1147,20,1,1187,1168,19,1,1654,1630,1590,3,14,15,5,26,27,123,297,489,397
31059,NE,"Fillmore County, NE",3213,3122,91,2,3303,3234,69,2,3363,3299,64,1,5572,5555,5553,18,66,67,18,74,75,229,1454,1485,903
31061,NE,"Franklin County, NE",1485,1434,51,3,1502,1468,34,2,1551,1515,36,2,2890,2891,2873,10,31,29,8,48,47,166,786,848,355
31063,NE,"Frontier County, NE",1561,1515,46,2,1575,1546,29,1,1523,1490,33,2,2504,2555,2633,6,24,24,8,24,27,99,476,713,419
31065,NE,"Furnas County, NE",2624,2551,73,2,2590,2537,53,2,2558,2507,51,2,4626,4611,4575,15,56,55,11,68,68,315,1026,1256,689
31067,NE,"Gage County, NE",11012,10564,448,4,10953,10666,287,2,10922,10643,279,2,21653,21611,21583,35,202,199,68,304,297,1382,5591,5138,3072
31069,NE,"Garden County, NE",1085,1046,39,3,1120,1096,24,2,1126,1103,23,2,1886,1833,1837,11,15,20,9,41,37,82,428,466,352
31071,NE,"Garfield County, NE",1165,1141,24,2,1152,1128,24,2,1150,1126,24,2,1807,1832,1801,6,27,26,10,31,30,45,346,584,406
31073,NE,"Gosper County, NE",1116,1087,29,2,1207,1186,21,1,1216,1192,24,2,1895,1819,1808,6,18,18,9,41,45,85,366,526,439
31075,NE,"Grant County, NE",421,413,8,1,426,420,6,1,421,414,7,1,615,577,576,2,9,11,1,14,14,33,137,165,132
31077,NE,"Greeley County, NE",1243,1206,37,3,1231,1207,24,1,1252,1226,26,2,2175,2184,2227,6,32,30,7,35,36,128,557,608,255
31079,NE,"Hall County, NE",32357,30464,1893,5,32613,31608,1005,3,32993,32188,805,2,62760,62092,62097,207,861,863,144,615,613,6073,12541,12864,8741
31081,NE,"Hamilton County, NE",4795,4614,181,3,4870,4760,110,2,4948,4844,104,2,9404,9382,9429,25,105,103,36,121,115,212,1778,2750,1695
31083,NE,"Harlan County, NE",1759,1708,51,2,1794,1758,36,2,1835,1800,35,1,3057,3097,3054,6,34,34,11,42,42,159,606,897,564
31085,NE,"Hayes County, NE",636,621,15,2,615,605,10,1,600,590,10,1,853,841,849,0,11,11,3,9,9,42,192,284,120
31087,NE,"Hitchcock County, NE",1327,1280,47,3,1325,1294,31,2,1313,1281,32,2,2622,2594,2598,8,30,29,11,57,57,92,567,841,335
31089,NE,"Holt County, NE",5787,5643,144,2,5721,5613,108,1,5722,5614,108,1,10113,10081,10043,36,127,126,25,133,129,444,2093,2578,1824
31091,NE,"Hooker County, NE",411,400,11,2,426,419,7,1,409,398,11,2,706,731,686,1,6,6,1,11,11,34,181,133,125
31093,NE,"Howard County, NE",3416,3265,151,4,3449,3369,80,2,3507,3432,75,2,6484,6519,6515,18,75,76,24,80,80,209,1777,1572,899
31095,NE,"Jefferson County, NE",4250,4132,118,2,4213,4131,82,1,4214,4132,82,1,7259,7160,7154,26,80,80,32,119,116,433,2010,1883,882
31097,NE,"Johnson County, NE",2085,2002,83,4,2014,1952,62,3,2027,1969,58,2,5292,5335,5287,15,42,42,13,53,53,437,1710,939,708
31099,NE,"Kearney County, NE",3854,3728,126,3,3840,3766,74,1,3767,3696,71,1,6681,6662,6690,17,81,82,20,74,74,230,1286,1730,1196
31101,NE,"Keith County, NE",4682,4530,152,3,4685,4583,102,2,4732,4643,89,1,8325,8298,8269,16,85,82,16,89,93,632,1749,2473,1226
31103,NE,"Keya Paha County, NE",586,573,13,2,587,577,10,1,557,545,12,2,759,787,787,1,8,4,4,10,11,29,187,230,172
31105,NE,"Kimball County, NE",1993,1921,72,3,1962,1915,47,2,1965,1928,37,1,3411,3405,3315,10,31,32,17,67,66,309,982,945,326
31107,NE,"Knox County, NE",4704,4560,144,3,4698,4594,104,2,4700,4592,108,2,8396,8436,8336,26,113,111,28,127,128,439,2057,2180,1085
31109,NE,"Lancaster County, NE",179050,171373,7677,4,178718,174040,4678,2,180363,176382,3981,2,323144,323420,324756,940,3704,3719,596,2589,2509,13317,41872,64351,80095
31111,NE,"Lincoln County, NE",18600,17857,743,4,18611,18170,441,2,18514,18101,413,2,34534,34078,33685,69,343,346,111,464,457,1475,7331,10247,5164
31113,NE,"Logan County, NE",477,465,12,2,473,464,9,1,489,478,11,2,715,684,675,3,8,8,5,13,14,23,139,254,149
31115,NE,"Loup County, NE",410,397,13,3,406,397,9,2,415,404,11,2,603,598,599,2,5,5,1,3,2,8,181,202,86
31117,NE,"McPherson County, NE",444,433,11,2,434,426,8,1,437,429,8,1,397,382,372,0,4,3,0,8,8,26,107,151,89
31119,NE,"Madison County, NE",19889,19111,778,3,20034,19517,517,2,19973,19548,425,2,35521,35360,35368,119,455,463,90,381,383,1828,7263,8417,5609
31121,NE,"Merrick County, NE",4097,3933,164,4,4160,4056,104,2,4214,4131,83,2,7655,7670,7721,20,86,84,23,94,93,372,2036,2137,888
31123,NE,"Morrill County, NE",2648,2552,96,3,2650,2581,69,2,2675,2618,57,2,4553,4573,4527,14,62,64,14,77,75,294,1075,1154,615
31125,NE,"Nance County, NE",1982,1917,65,3,1965,1925,40,2,1973,1932,41,2,3390,3380,3326,10,37,38,9,60,60,164,792,980,425
31127,NE,"Nemaha County, NE",3637,3505,132,3,3657,3570,87,2,3646,3560,86,2,7085,7000,7035,12,85,85,19,99,101,419,1317,1497,1345
31129,NE,"Nuckolls County, NE",2485,2417,68,2,2494,2444,50,2,2514,2459,55,2,4090,4063,4041,8,39,40,14,82,82,237,983,1111,683
31131,NE,"Otoe County, NE",8479,8173,306,3,8587,8374,213,2,8625,8427,198,2,15897,16008,16198,41,191,194,46,183,179,763,3635,3609,2866
31133,NE,"Pawnee County, NE",1508,1467,41,2,1529,1499,30,2,1500,1467,33,2,2536,2540,2528,4,29,33,6,46,46,268,714,541,291
31135,NE,"Perkins County, NE",1866,1831,35,1,1869,1842,27,1,1879,1847,32,1,2863,2822,2829,8,28,29,3,38,37,207,472,811,475
31137,NE,"Phelps County, NE",5027,4876,151,3,4977,4883,94,1,5037,4937,100,2,8972,8933,8988,26,104,109,20,117,121,490,1744,2338,1591
31139,NE,"Pierce County, NE",4191,4052,139,3,4187,4090,97,2,4234,4151,83,2,7340,7316,7332,30,94,102,11,75,77,276,1672,1847,1116
31141,NE,"Platte County, NE",18004,17330,674,3,18308,17885,423,2,18600,18208,392,2,34283,34282,34296,105,468,461,70,344,344,2575,6651,7994,5301
31143,NE,"Polk County, NE",2955,2865,90,3,2950,2891,59,2,2925,2866,59,2,5212,5159,5166,9,50,51,23,100,104,315,1316,1327,655
31145,NE,"Red Willow County, NE",5906,5711,195,3,5884,5757,127,2,5961,5842,119,2,10686,10639,10573,38,126,126,34,152,150,530,2278,2710,1707
31147,NE,"Richardson County, NE",4253,4112,141,3,4278,4168,110,2,4198,4110,88,2,7860,7783,7705,19,81,81,27,157,156,367,2261,1966,1108
31149,NE,"Rock County, NE",891,872,19,2,884,871,13,1,909,894,15,1,1266,1271,1245,3,19,19,3,21,21,38,285,330,275
31151,NE,"Saline County, NE",7402,7131,271,3,7303,7121,182,2,7247,7060,187,2,14242,14052,14116,49,186,193,31,114,113,1761,2472,3038,1620
31153,NE,"Sarpy County, NE",98253,94178,4075,4,98614,96096,2518,2,100026,97756,2270,2,191157,193798,196553,619,2382,2397,298,1315,1287,5436,25261,40635,49839
31155,NE,"Saunders County, NE",11423,10999,424,3,11493,11218,275,2,11611,11370,241,2,22372,22798,23118,58,253,253,58,278,280,796,4546,5267,4348
31157,NE,"Scotts Bluff County, NE",18347,17570,777,4,18201,17666,535,2,18056,17580,476,2,36036,35828,35603,84,425,424,96,536,531,2578,6881,8702,6063
31159,NE,"Seward County, NE",8880,8509,371,4,8860,8624,236,2,8924,8726,198,2,17614,17584,17692,60,190,195,43,182,181,622,3154,3901,3376
31161,NE,"Sheridan County, NE",2743,2676,67,2,2762,2708,54,2,2810,2753,57,2,5104,5086,4996,11,48,53,22,85,89,360,1170,1309,712
31163,NE,"Sherman County, NE",1683,1629,54,3,1696,1658,38,2,1670,1632,38,2,2956,2953,2980,6,31,31,12,56,55,182,762,785,445
31165,NE,"Sioux County, NE",770,752,18,2,771,756,15,1,773,758,15,1,1144,1151,1127,4,11,8,4,11,11,40,194,336,195
31167,NE,"Stanton County, NE",3569,3448,121,3,3615,3533,82,2,3587,3514,73,2,5822,5797,5717,12,59,60,12,77,70,204,1216,1693,804
31169,NE,"Thayer County, NE",2798,2720,78,2,2712,2663,49,1,2727,2675,52,1,5019,4906,4885,8,46,47,14,77,76,228,1164,1328,801
31171,NE,"Thomas County, NE",432,414,18,4,435,423,12,2,459,447,12,2,670,676,671,2,8,8,2,5,5,34,106,196,109
31173,NE,"Thurston County, NE",3138,2973,165,5,3217,3102,115,3,3287,3176,111,3,6752,6595,6507,31,132,128,36,110,105,346,1266,1351,692
31175,NE,"Valley County, NE",2148,2086,62,2,2121,2073,48,2,2134,2087,47,2,4055,4074,4073,10,49,50,10,47,51,174,859,1067,749
31177,NE,"Washington County, NE",11306,10887,419,3,11371,11090,281,2,11530,11281,249,2,20928,20993,21167,46,196,200,40,210,210,618,3840,4890,4759
31179,NE,"Wayne County, NE",5732,5568,164,2,5752,5633,119,2,5771,5646,125,2,9694,9843,9871,21,103,103,18,82,78,208,1578,1846,1820
31181,NE,"Webster County, NE",1669,1606,63,3,1661,1625,36,2,1694,1652,42,2,3390,3393,3336,9,39,38,9,64,63,137,789,1021,476
31183,NE,"Wheeler County, NE",571,560,11,1,557,550,7,1,565,556,9,1,775,787,785,3,10,10,0,9,10,30,155,257,154
31185,NE,"York County, NE",7351,7101,250,3,7343,7189,154,2,7479,7319,160,2,14103,14248,14354,29,152,155,28,160,160,544,2776,3831,2415
32000,NV,Nevada,1506631,1302990,203641,13,1499499,1395651,103848,6,1549859,1466213,83646,5,3115648,3146402,3177772,8166,33289,33784,7016,32428,33392,274760,587588,702767,551603
32001,NV,"Churchill County, NV",11084,10438,646,5,11059,10687,372,3,10906,10515,391,3,25568,25671,25843,63,271,274,79,382,395,1101,5574,7155,3223
32003,NV,"Clark County, NV",1106764,935250,171514,15,1097343,1010123,87220,7,1143945,1075282,68663,6,2274734,2295194,2322985,6083,25012,25385,4843,22384,23153,208620,428431,499232,395192
32005,NV,"Douglas County, NV",22186,20182,2004,9,21879,20927,952,4,22138,21253,885,4,49522,49969,49628,85,324,329,142,649,669,2206,9422,14503,12187
32007,NV,"Elko County, NV",26189,24614,1575,6,25634,24825,809,3,25543,24715,828,3,53670,53811,54046,161,675,680,93,480,482,3812,11957,13088,5628
32009,NV,"Esmeralda County, NV",418,396,22,5,422,407,15,3,409,394,15,3,732,733,744,0,5,6,0,17,16,173,228,306,167
32011,NV,"Eureka County, NV",1023,986,37,3,1047,1022,25,2,999,970,29,2,1853,1909,1863,5,20,18,3,23,26,50,418,432,112
32013,NV,"Humboldt County, NV",8030,7623,407,5,8123,7859,264,3,7739,7482,257,3,17276,17591,17272,55,213,217,39,189,194,1579,3877,3615,2207
32015,NV,"Lander County, NV",3138,2982,156,5,3141,3033,108,3,3004,2903,101,3,5726,5762,5766,20,66,68,21,69,71,458,1473,1613,316
32017,NV,"Lincoln County, NV",2032,1927,105,5,2123,2055,68,3,2029,1949,80,3,4448,4433,4482,15,52,50,16,55,63,442,1361,1041,509
32019,NV,"Lyon County, NV",22722,20671,2051,9,23278,22122,1156,5,23476,22330,1146,4,59466,60927,61585,153,602,617,182,868,884,5618,13109,16515,6679
32021,NV,"Mineral County, NV",2114,1990,124,5,2048,1973,75,3,1967,1887,80,4,4557,4615,4525,10,36,36,23,100,99,368,1257,1202,451
32023,NV,"Nye County, NV",17429,15645,1784,10,17116,16108,1008,5,17427,16431,996,5,51960,53277,54738,93,359,366,218,1043,1075,5280,14121,14626,4947
32027,NV,"Pershing County, NV",2569,2442,127,4,2594,2509,85,3,2475,2385,90,3,6622,6442,6462,15,51,52,11,68,82,811,2214,1547,529
32029,NV,"Storey County, NV",2017,1843,174,8,2042,1952,90,4,2086,2003,83,4,4106,4145,4170,4,24,24,5,44,47,184,825,1173,860
32031,NV,"Washoe County, NV",248708,228218,20490,8,251733,241420,10313,4,256072,247203,8869,3,487674,494281,496745,1241,4961,5031,1091,4935,5011,38258,79277,108465,108033
32033,NV,"White Pine County, NV",4557,4361,196,4,4588,4457,131,2,4468,4331,137,3,9051,8846,8788,28,88,93,28,98,99,662,2982,2366,930
32510,NV,"Carson City, NV",25655,23423,2232,8,25331,24173,1158,4,25180,24181,999,4,58683,58796,58130,135,530,538,222,1024,1026,5138,11062,15888,9633
33000,NH,New Hampshire,764137,713144,50993,6,756858,731117,25741,3,766672,747339,19333,2,1378587,1387505,1395231,2994,12107,12670,3477,13693,14700,62809,269342,276920,377035
33001,NH,"Belknap County, NH",31092,28930,2162,7,31059,29946,1113,3,31110,30324,786,2,63775,64612,64781,123,478,499,204,818,858,3059,13873,15691,14799
33003,NH,"Carroll County, NH",23115,21341,1774,7,23217,22356,861,3,23355,22742,613,2,50235,51725,52199,79,307,319,131,597,621,1926,10882,11776,14668
33005,NH,"Cheshire County, NH",39813,37360,2453,6,39506,38033,1473,3,39369,38308,1061,2,76541,76821,77350,154,671,702,187,853,881,3403,17152,15564,17841
33007,NH,"Coos County, NH",14305,13172,1133,7,14349,13734,615,4,14420,13938,482,3,31227,31411,31504,67,230,243,97,517,552,2634,9530,7299,4860
33009,NH,"Grafton County, NH",48134,45316,2818,5,48466,46900,1566,3,48935,47799,1136,2,91177,90474,91126,169,687,710,220,905,956,4510,16565,15889,27392
33011,NH,"Hillsborough County, NH",241174,224360,16814,7,237396,229102,8294,3,241297,235077,6220,2,422883,424496,426594,1022,4138,4344,1107,3843,4211,21212,76529,82795,118559
33013,NH,"Merrimack County, NH",82841,78027,4814,5,81529,78985,2544,3,82627,80740,1887,2,154022,154591,156020,326,1299,1361,370,1518,1637,7469,31996,31024,39362
33015,NH,"Rockingham County, NH",186995,173837,13158,7,185310,179102,6208,3,188661,183774,4887,2,314603,318214,319424,680,2759,2889,752,2871,3120,10263,57660,63120,98141
33017,NH,"Strafford County, NH",73620,69004,4616,6,73061,70730,2331,3,74084,72366,1718,2,131055,131534,132275,304,1193,1244,307,1285,1344,5327,23050,26148,31864
33019,NH,"Sullivan County, NH",23048,21800,1248,5,22970,22232,738,3,22816,22274,542,2,43069,43627,43958,70,345,359,102,486,520,3006,12105,7614,9549
34000,NJ,New Jersey,4650326,4212389,437937,9,4666108,4357217,308891,6,4739804,4564113,175691,3,9271689,9267961,9261699,24719,97795,102555,33957,84110,82804,608877,1693560,1448316,2660853
34001,NJ,"Atlantic County, NJ",124023,102850,21173,17,122443,110426,12017,9,122846,116536,6310,5,274172,275130,275638,693,2742,2876,951,3262,3240,23333,61970,49693,56247
34003,NJ,"Bergen County, NJ",495140,449744,45396,9,494034,462974,31060,6,504149,487246,16903,3,953617,954879,952997,2202,8730,9145,3587,7803,7606,47805,143874,136582,344832
34005,NJ,"Burlington County, NJ",239790,220858,18932,7,242415,228857,13558,5,247859,239613,8246,3,461648,464411,466103,1056,4438,4687,1503,4515,4440,19683,87753,88368,130269
34007,NJ,"Camden County, NJ",265237,239598,25639,9,266980,248194,18786,7,270737,259883,10854,4,523074,524124,524907,1420,5885,6260,1714,5616,5498,38904,104746,95014,121011
34009,NJ,"Cape May County, NJ",45902,39611,6291,13,47274,42925,4349,9,47294,44225,3069,6,95040,95768,95634,196,742,772,398,1393,1380,4282,22516,19970,25157
34011,NJ,"Cumberland County, NJ",68696,61577,7119,10,68933,63428,5505,8,69282,65773,3509,5,153692,152089,151356,424,1773,1866,543,1862,1869,20134,40994,25763,17858
34013,NJ,"Essex County, NJ",388321,344710,43611,11,386907,354945,31962,8,388106,370619,17487,4,859924,854121,849477,2439,9540,9967,3608,6912,6797,76672,160988,126530,210714
34015,NJ,"Gloucester County, NJ",157268,143282,13986,8,158400,148428,9972,6,161341,155427,5914,3,302554,304620,306601,674,2798,2950,897,3166,3125,13216,65461,58178,72018
34017,NJ,"Hudson County, NJ",373507,335570,37937,10,371485,345305,26180,7,377212,363531,13681,3,721832,703447,703366,2380,9176,9625,2474,4569,4494,67627,121831,88493,233671
34019,NJ,"Hunterdon County, NJ",65980,61425,4555,6,66538,63325,3213,4,68083,66102,1981,2,128786,129668,129777,268,1017,1059,389,996,984,3999,18549,19828,50390
34021,NJ,"Mercer County, NJ",211802,196545,15257,7,212695,201071,11624,5,216475,209584,6891,3,386441,382116,380688,1014,3914,4131,1322,3380,3356,27089,65735,53505,113117
34023,NJ,"Middlesex County, NJ",447575,409642,37933,8,453523,426211,27312,6,462728,447235,15493,3,861314,862328,861418,2233,8477,8817,2902,6855,6726,59639,142301,124490,265393
34025,NJ,"Monmouth County, NJ",337006,308222,28784,8,340808,320957,19851,5,347991,336497,11494,3,642771,646392,644098,1468,5842,6156,2257,6313,6238,26629,99443,107043,219649
34027,NJ,"Morris County, NJ",261858,242323,19535,7,263377,249549,13828,5,268713,260558,8155,3,508384,510444,511151,1161,4704,4881,1869,4245,4201,19500,68137,70789,199629
34029,NJ,"Ocean County, NJ",289547,263207,26340,9,292423,274068,18355,6,298372,287322,11050,3,638422,649741,655735,2363,9601,10065,2753,8156,7970,30778,143516,116757,138402
34031,NJ,"Passaic County, NJ",253441,222723,30718,12,250793,229185,21608,8,252876,241305,11571,4,523406,518345,513936,1613,6155,6433,2116,4317,4252,51861,117593,73448,103352
34033,NJ,"Salem County, NJ",30636,27807,2829,9,30533,28202,2331,7,30578,29170,1408,4,64842,65058,65117,167,663,686,257,903,903,4324,17413,13065,10601
34035,NJ,"Somerset County, NJ",174553,161515,13038,7,175699,166299,9400,5,179242,173670,5572,3,344725,346331,346875,761,3015,3121,1145,2702,2631,13619,46231,45825,135200
34037,NJ,"Sussex County, NJ",76375,69482,6893,9,76360,71607,4753,6,77612,74747,2865,3,143915,145645,146084,327,1295,1369,547,1431,1403,4850,31010,28905,39868
34039,NJ,"Union County, NJ",286019,258755,27264,9,286173,266350,19823,6,289390,278184,11206,3,573617,572810,569815,1626,6358,6649,2296,4564,4548,49584,108536,84888,146361
34041,NJ,"Warren County, NJ",57652,52942,4710,8,58320,54913,3407,5,58921,56887,2034,3,109513,110494,110926,234,930,1040,429,1150,1143,5349,24963,21182,27114
35000,NM,New Mexico,931921,858350,73571,7,943382,876730,66652,7,947025,908870,38155,4,2118390,2116677,2113344,5328,21322,20955,5509,24691,25250,188715,371398,459485,407041
35001,NM,"Bernalillo County, NM",327380,302607,24773,7,334317,312649,21668,6,336801,324606,12195,3,676803,674980,672508,1608,6369,6250,1691,7605,7600,45471,104898,147590,170154
35003,NM,"Catron County, NM",1141,1061,80,7,1176,1098,78,6,1136,1078,58,5,3611,3726,3827,1,11,11,8,44,47,151,1224,1059,494
35005,NM,"Chaves County, NM",27511,25403,2108,7,27887,25847,2040,7,27668,26493,1175,4,65148,64644,63894,177,783,766,188,872,892,8378,11058,15167,7057
35006,NM,"Cibola County, NM",8935,8153,782,8,8761,7909,852,9,8170,7723,447,5,27102,27238,26950,73,300,292,80,361,403,3343,5933,6232,2876
35007,NM,"Colfax County, NM",5078,4736,342,6,5531,5181,350,6,5348,5140,208,3,12353,12356,12246,23,93,91,29,193,197,953,2907,3339,2006
35009,NM,"Curry County, NM",21840,20708,1132,5,22221,21064,1157,5,22286,21568,718,3,48370,47960,47532,216,778,774,112,490,506,5770,7251,10558,6371
35011,NM,"De Baca County, NM",693,661,32,4,688,651,37,5,731,706,25,3,1683,1679,1693,6,16,16,7,40,42,192,273,432,107
35013,NM,"Dona Ana County, NM",96552,89002,7550,7,98555,91732,6823,6,99532,95167,4365,4,220047,221655,223337,560,2396,2351,472,2370,2456,25731,28774,38982,40141
35015,NM,"Eddy County, NM",32941,30804,2137,6,31515,29423,2092,6,31434,30394,1040,3,62329,60899,60400,199,801,784,134,665,674,6690,12343,13726,6662
35017,NM,"Grant County, NM",11732,10741,991,8,11468,10605,863,7,11572,11096,476,4,28203,27892,27686,59,249,243,101,444,464,2601,5552,6753,5428
35019,NM,"Guadalupe County, NM",1488,1393,95,6,1603,1485,118,7,1473,1391,82,5,4440,4432,4310,8,38,38,21,61,64,564,1712,891,293
35021,NM,"Harding County, NM",275,264,11,4,281,267,14,5,283,273,10,3,655,636,628,2,2,2,4,14,14,54,116,132,101
35023,NM,"Hidalgo County, NM",1907,1802,105,5,1890,1782,108,5,1893,1829,64,3,4166,4090,4003,17,38,38,9,72,76,493,1118,798,528
35025,NM,"Lea County, NM",28946,25925,3021,10,28006,25266,2740,9,29083,27800,1283,4,74635,73103,72452,277,1110,1089,139,731,756,10313,14128,12514,6440
35027,NM,"Lincoln County, NM",8648,7912,736,8,8783,8099,684,7,8833,8478,355,4,20313,20421,20411,41,158,156,59,249,253,1519,4662,5434,3754
35028,NM,"Los Alamos County, NM",9762,9416,346,3,10021,9698,323,3,10637,10405,232,2,19415,19340,19187,36,153,148,37,151,156,248,1327,2716,9340
35029,NM,"Luna County, NM",10134,8578,1556,15,10151,8601,1550,15,9832,8856,976,9,25447,25486,25749,99,361,352,81,403,418,4742,5783,3759,1954
35031,NM,"McKinley County, NM",23506,21205,2301,9,23326,21004,2322,10,22791,21495,1296,5,72578,71484,69830,228,838,827,348,1197,1241,9492,16513,13908,5551
35033,NM,"Mora County, NM",2025,1870,155,7,1993,1861,132,6,1948,1841,107,5,4192,4203,4169,14,37,37,7,49,57,276,1320,1219,582
35035,NM,"Otero County, NM",25123,23135,1988,7,25288,23553,1735,6,25252,24214,1038,4,67873,68538,68823,210,809,802,184,785,802,6138,13082,16643,9036
35037,NM,"Quay County, NM",3024,2811,213,7,2951,2732,219,7,2969,2840,129,4,8712,8624,8546,19,79,79,39,170,177,974,2498,1745,959
35039,NM,"Rio Arriba County, NM",16420,15162,1258,7,16503,15286,1217,7,16518,15800,718,4,40269,40249,40048,81,400,393,102,492,530,3797,9735,9229,4903
35041,NM,"Roosevelt County, NM",7798,7344,454,5,7866,7400,466,5,7930,7630,300,3,19157,19017,18934,52,199,196,28,202,208,1905,3504,3386,2445
35043,NM,"Sandoval County, NM",66308,61035,5273,8,67714,63060,4654,6,68055,65476,2579,3,149276,151439,153501,310,1288,1269,331,1472,1520,8793,25447,36189,31571
35045,NM,"San Juan County, NM",49792,45122,4670,9,49233,45113,4120,8,49295,47017,2278,4,121368,120866,120418,344,1302,1287,439,1582,1659,11330,24190,32610,11944
35047,NM,"San Miguel County, NM",10387,9582,805,7,10358,9566,792,7,10281,9773,508,4,27129,27167,26953,51,214,213,83,313,320,3022,4914,7116,4723
35049,NM,"Santa Fe County, NM",70745,65310,5435,7,72373,67706,4667,6,72319,69720,2599,3,155041,155404,155664,273,1081,1061,350,1555,1558,11417,25053,31329,47367
35051,NM,"Sierra County, NM",4052,3698,354,8,4099,3755,344,8,3957,3723,234,5,11563,11498,11436,24,83,79,66,321,330,958,3246,3132,1810
35053,NM,"Socorro County, NM",6134,5724,410,6,6200,5788,412,6,6149,5885,264,4,16558,16303,16115,35,164,163,52,226,242,1747,4382,2728,1969
35055,NM,"Taos County, NM",14630,13038,1592,10,14744,13393,1351,9,14779,14056,723,4,34459,34700,34580,58,237,233,73,419,425,2051,6951,8525,8458
35057,NM,"Torrance County, NM",5298,4825,473,8,5412,4970,442,8,5440,5147,293,5,15054,15318,15454,30,147,145,34,189,193,1313,3938,3554,1580
35059,NM,"Union County, NM",1623,1545,78,4,1566,1495,71,4,1562,1517,45,2,4072,4097,3980,6,38,39,14,63,65,453,1258,714,469
35061,NM,"Valencia County, NM",30094,27780,2314,7,30904,28694,2210,7,31067,29734,1333,4,76369,77233,78080,191,750,731,187,891,905,7836,16308,17376,9968
36000,NY,New York,9580847,8645489,935358,9,9557912,8886155,671757,7,9616989,9205821,411168,4,20108296,19857492,19677151,53083,205802,212145,72523,177143,176534,1769657,3553598,3391113,5366712
36001,NY,"Albany County, NY",159996,148962,11034,6,158446,151431,7015,4,159594,154764,4830,3,313987,316301,315811,740,2760,2852,844,2984,2997,15177,44863,57582,93623
36003,NY,"Allegany County, NY",19498,17990,1508,7,19246,18277,969,5,19108,18337,771,4,47320,46921,46694,125,446,459,126,531,519,2702,10579,10022,6716
36005,NY,"Bronx County, NY",613416,515459,97957,16,614171,529675,84496,13,603694,556635,47059,7,1461125,1421089,1379946,4455,17555,18102,7137,12632,12483,248215,267253,243073,200891
36007,NY,"Broome County, NY",83823,76847,6976,8,82480,78148,4332,5,82307,79201,3106,3,198126,198703,197117,422,1753,1806,571,2299,2323,12413,40251,40977,38078
36009,NY,"Cattaraugus County, NY",33819,30741,3078,9,33268,31500,1768,5,32844,31521,1323,4,76992,76650,76439,216,798,826,208,913,914,5515,21080,15818,10620
36011,NY,"Cayuga County, NY",36232,33483,2749,7,35634,33943,1691,4,35580,34363,1217,3,76198,75791,74998,182,681,707,213,864,860,6635,17969,18702,12338
36013,NY,"Chautauqua County, NY",54130,49517,4613,8,53569,50589,2980,5,53318,51257,2061,3,127578,126785,126027,320,1213,1256,340,1525,1533,9568,31002,28147,20915
36015,NY,"Chemung County, NY",36122,33083,3039,8,34998,33159,1839,5,34832,33560,1272,3,83945,82830,81426,204,785,815,240,1088,1097,6285,20455,18616,14256
36017,NY,"Chenango County, NY",22243,20770,1473,6,22037,21065,972,4,21872,21156,716,3,47067,46637,46458,117,421,432,157,598,592,3810,14001,9995,6210
36019,NY,"Clinton County, NY",36298,33521,2777,7,35644,33981,1663,4,35418,34236,1182,3,79761,79996,78753,150,627,649,183,770,766,6871,19428,14868,14002
36021,NY,"Columbia County, NY",31049,29203,1846,5,30597,29418,1179,3,30539,29703,836,2,61403,62039,61286,113,447,460,199,645,640,4131,13856,12653,16415
36023,NY,"Cortland County, NY",22908,21148,1760,7,22562,21418,1144,5,22719,21863,856,3,46750,46489,46126,133,445,457,120,514,502,2927,9035,9242,8274
36025,NY,"Delaware County, NY",19065,17739,1326,7,18827,17934,893,4,18575,17895,680,3,44221,44753,44740,105,351,364,138,569,561,3282,13047,9092,7586
36027,NY,"Dutchess County, NY",145395,134736,10659,7,144326,137869,6457,4,145231,140788,4443,3,295398,298039,297545,664,2529,2607,803,2767,2784,17701,54838,57690,78716
36029,NY,"Erie County, NY",447675,406773,40902,9,442602,418604,23998,5,444485,428562,15923,3,952598,954350,950312,2398,9311,9588,3048,10560,10617,52956,175869,200762,240472
36031,NY,"Essex County, NY",16947,15615,1332,7,16858,16052,806,4,16501,15910,591,3,37326,37292,36910,63,264,270,121,456,455,2562,9713,7845,8817
36033,NY,"Franklin County, NY",19555,18002,1553,7,19312,18389,923,4,18961,18282,679,3,47565,47040,46373,122,441,449,112,466,462,4068,12979,9840,7418
36035,NY,"Fulton County, NY",23030,21130,1900,8,22548,21299,1249,5,22433,21548,885,3,53132,53055,52669,107,418,429,179,643,642,4926,14303,12511,7085
36037,NY,"Genesee County, NY",29683,27585,2098,7,29599,28326,1273,4,29695,28769,926,3,58313,57988,57535,157,543,558,155,710,709,3096,16063,13474,9197
36039,NY,"Greene County, NY",20683,19034,1649,8,20463,19439,1024,5,20288,19572,716,3,47912,48493,48061,110,395,410,132,529,526,4359,13319,9193,9253
36041,NY,"Hamilton County, NY",2204,2035,169,7,2221,2120,101,4,2197,2103,94,4,5073,5114,5118,8,22,22,24,71,71,809,1074,1286,816
36043,NY,"Herkimer County, NY",28133,25919,2214,7,27700,26088,1612,5,27354,26285,1069,3,60024,60082,59822,138,587,611,174,682,689,3928,15415,14444,9220
36045,NY,"Jefferson County, NY",44340,40621,3719,8,44090,41842,2248,5,44238,42464,1774,4,116273,117680,116637,492,1761,1813,229,930,941,6605,24284,25725,18194
36047,NY,"Kings County, NY",1202973,1053548,149425,12,1207802,1083270,124532,10,1208843,1137876,70967,5,2719044,2637486,2590516,8415,33859,34912,11098,19791,19604,305982,473782,355048,741880
36049,NY,"Lewis County, NY",11673,10804,869,7,11634,11043,591,5,11669,11202,467,4,26551,26745,26699,68,277,284,61,216,216,1644,8038,5378,3491
36051,NY,"Livingston County, NY",30427,28352,2075,6,30136,28816,1320,4,30331,29334,997,3,61728,61629,61516,142,497,512,136,567,569,3421,12917,13549,12150
36053,NY,"Madison County, NY",33134,30638,2496,7,32577,31083,1494,4,32900,31794,1106,3,67927,67397,67097,146,544,564,156,709,708,3371,16439,14515,12216
36055,NY,"Monroe County, NY",367856,337779,30077,8,363970,345113,18857,5,365242,352688,12554,3,757790,756547,752035,1927,7402,7629,1985,7465,7501,46804,121141,147572,209945
36057,NY,"Montgomery County, NY",22571,20672,1899,8,22158,20905,1253,5,22317,21420,897,4,49485,49611,49623,160,624,640,141,645,636,3885,12202,11572,6585
36059,NY,"Nassau County, NY",714431,657096,57335,8,716363,684207,32156,4,729471,708503,20968,2,1390559,1391112,1383726,3327,13079,13479,5578,12098,12002,80511,211529,217573,460743
36061,NY,"New York County, NY",897177,812003,85174,9,905061,835020,70041,7,919101,876980,42121,4,1677306,1578801,1596273,3865,14508,14918,5549,11718,11626,148767,156704,174128,801081
36063,NY,"Niagara County, NY",99782,89737,10045,10,97760,92250,5510,5,98124,94379,3745,3,212125,211891,210880,499,1938,1997,748,2666,2699,12783,48485,51227,40182
36065,NY,"Oneida County, NY",103011,94976,8035,7,100877,95724,5153,5,100117,96564,3553,3,231575,229942,228846,656,2351,2422,780,2818,2850,17958,49484,51008,42105
36067,NY,"Onondaga County, NY",225537,207481,18056,8,222326,211362,10964,4,224277,216902,7375,3,474316,472094,468249,1226,4777,4925,1275,4898,4957,28245,82746,95544,118738
36069,NY,"Ontario County, NY",56020,52127,3893,6,55530,53141,2389,4,55909,54201,1708,3,112327,112660,112707,234,926,959,286,1077,1069,5358,20288,24085,29828
36071,NY,"Orange County, NY",187690,172718,14972,8,186835,178023,8812,4,190481,184393,6088,3,401088,404997,405941,1313,5135,5311,1148,3155,3157,25676,72736,76159,80054
36073,NY,"Orleans County, NY",17455,16050,1405,8,17149,16258,891,5,17176,16531,645,3,40225,39711,39318,100,381,393,144,473,473,3866,12062,8662,5120
36075,NY,"Oswego County, NY",53257,48666,4591,8,52429,49530,2899,5,52915,50779,2136,4,117440,118124,118287,293,1138,1177,254,1140,1131,8256,29943,25426,16735
36077,NY,"Otsego County, NY",27225,25341,1884,6,27092,25871,1221,4,27070,26137,933,3,58377,60758,60636,121,459,474,166,661,652,2845,12789,10818,13234
36079,NY,"Putnam County, NY",51502,47794,3708,7,51101,48961,2140,4,51546,50033,1513,2,97632,98176,98045,215,822,850,293,806,809,4702,18591,17977,29267
36081,NY,"Queens County, NY",1143255,1001408,141847,12,1140951,1029434,111517,9,1141061,1081470,59591,5,2388586,2328141,2278029,6260,24233,24973,10705,18090,17897,299347,461885,382218,587052
36083,NY,"Rensselaer County, NY",82398,76864,5534,6,81726,78127,3599,4,82323,79811,2512,3,160900,160740,159853,394,1544,1589,407,1589,1609,8773,31059,34829,39039
36085,NY,"Richmond County, NY",221735,198512,23223,10,223987,203967,20020,8,227068,214589,12479,5,494586,493484,491133,1307,4882,5034,1918,4295,4271,39258,102905,82052,120174
36087,NY,"Rockland County, NY",156756,144690,12066,7,156366,149461,6905,4,159361,154822,4539,2,337394,339256,339022,1391,5626,5810,1323,2673,2631,23304,46259,51798,87754
36089,NY,"St. Lawrence County, NY",43955,40501,3454,7,43453,41208,2245,5,42939,41172,1767,4,108554,108410,107733,269,970,1001,241,1078,1085,8203,25640,21166,16962
36091,NY,"Saratoga County, NY",122095,114247,7848,6,120739,116123,4616,3,121807,118577,3230,2,235794,237962,238797,503,1924,1987,483,1990,1998,10652,40688,45785,72252
36093,NY,"Schenectady County, NY",78680,72622,6058,7,77664,73829,3835,4,78021,75444,2577,3,159315,160214,160093,450,1773,1824,457,1645,1655,9470,29584,33850,36330
36095,NY,"Schoharie County, NY",14867,13854,1013,6,14693,14017,676,4,14798,14264,534,3,29752,30152,30063,56,240,247,61,317,315,2015,7817,6667,4995
36097,NY,"Schuyler County, NY",8228,7544,684,8,8149,7746,403,4,8051,7755,296,3,17863,17800,17650,37,159,163,49,215,214,1220,4650,4189,3237
36099,NY,"Seneca County, NY",15606,14388,1218,7,15198,14477,721,4,14852,14375,477,3,33747,33576,32882,89,339,349,86,377,375,3738,8166,7343,5260
36101,NY,"Steuben County, NY",42899,39530,3369,7,41909,39810,2099,5,41353,39856,1497,3,93314,93105,92599,235,910,941,270,1118,1121,5659,23375,20727,17009
36103,NY,"Suffolk County, NY",783518,719988,63530,8,785251,749254,35997,4,800832,775848,24984,3,1521950,1533118,1525465,3897,14538,14960,5747,13793,13761,102304,274855,279776,407900
36105,NY,"Sullivan County, NY",36673,33602,3071,8,36594,34800,1794,4,37373,36153,1220,3,78605,79694,79658,206,847,878,262,845,832,7399,17906,15067,14952
36107,NY,"Tioga County, NY",22658,20957,1701,7,22266,21274,992,4,22261,21546,715,3,48352,48087,47772,118,432,448,140,548,547,2537,12438,10797,8968
36109,NY,"Tompkins County, NY",49802,46903,2899,5,49783,47908,1875,3,50077,48687,1390,2,99784,106044,104777,176,656,676,146,681,674,3135,10847,13818,34348
36111,NY,"Ulster County, NY",87931,81165,6766,7,87347,83249,4098,4,87617,84853,2764,3,181627,183704,182319,360,1459,1497,523,1871,1874,11452,37702,38283,46012
36113,NY,"Warren County, NY",31553,28988,2565,8,31306,29763,1543,4,31288,30212,1076,3,65618,65773,65599,104,481,498,196,754,753,4183,13854,14959,16291
36115,NY,"Washington County, NY",27737,25816,1921,6,27635,26356,1279,4,27552,26662,890,3,61202,60975,60841,141,531,546,166,720,721,5108,17596,13114,9286
36117,NY,"Wayne County, NY",43813,40696,3117,7,43290,41339,1951,4,43492,42101,1391,3,91193,91201,91125,232,884,913,221,929,938,6281,21139,21695,15885
36119,NY,"Westchester County, NY",488596,449454,39142,8,487910,464437,23473,4,496415,480910,15505,3,1001431,999607,990427,2455,9463,9762,3693,8222,8180,77286,127801,137037,351129
36121,NY,"Wyoming County, NY",18284,16964,1320,7,18053,17234,819,4,17510,16899,611,3,40427,40017,39666,87,329,340,111,443,443,3432,11187,9624,5361
36123,NY,"Yates County, NY",11844,11103,741,6,11650,11200,450,3,11671,11328,343,2,24720,24634,24451,68,312,321,67,301,298,2286,5693,4521,4050
37000,NC,North Carolina,4839372,4491749,347623,7,4954783,4712866,241917,4,5159329,4970998,188331,3,10449445,10565885,10698973,28675,116827,122179,25879,115142,115720,776686,1787594,2181433,2339163
37001,NC,"Alamance County, NC",78765,73185,5580,7,81023,77064,3959,4,83174,80087,3087,3,171954,173876,176353,437,1853,1940,485,2135,2148,13953,32480,37206,29920
37003,NC,"Alexander County, NC",17091,15826,1265,7,17375,16630,745,4,18058,17481,577,3,36482,36467,36512,85,354,368,91,500,508,3921,10424,7936,3901
37005,NC,"Alleghany County, NC",4097,3802,295,7,4226,4026,200,4,4531,4356,175,3,10897,11066,11185,19,102,105,39,177,168,1722,2610,2342,1709
37007,NC,"Anson County, NC",10083,9323,760,7,10083,9439,644,6,10260,9813,447,4,22033,22254,22202,54,268,278,71,373,379,2804,6566,4752,1881
37009,NC,"Ashe County, NC",12218,11465,753,6,12591,12078,513,4,12919,12482,437,3,26580,26764,27110,54,218,226,95,419,420,2638,6342,7372,3975
37011,NC,"Avery County, NC",7080,6640,440,6,7348,7049,299,4,7747,7495,252,3,17848,17502,17571,34,136,138,51,277,257,1891,4023,4450,3252
37013,NC,"Beaufort County, NC",18803,17630,1173,6,19444,18485,959,4,19905,19120,785,3,44690,44438,44272,118,432,453,139,717,742,4026,10453,11555,6660
37015,NC,"Bertie County, NC",7363,6901,462,6,7155,6722,433,6,7162,6813,349,4,17862,17425,17240,46,167,174,69,314,315,2686,4990,3838,2026
37017,NC,"Bladen County, NC",14030,13029,1001,7,14220,13385,835,5,14529,13899,630,4,29629,29565,29446,78,344,352,118,504,514,3229,6966,7502,3807
37019,NC,"Brunswick County, NC",51687,47208,4479,8,53997,50708,3289,6,57304,54636,2668,4,138157,144814,153064,221,1035,1089,418,1846,1878,7671,29757,35290,33707
37021,NC,"Buncombe County, NC",133240,122360,10880,8,136559,130767,5792,4,141963,137753,4210,3,269694,271719,273589,583,2352,2455,733,3328,3290,16059,45409,52487,83474
37023,NC,"Burke County, NC",38527,35796,2731,7,39477,37656,1821,4,40970,39563,1407,3,87577,87634,87881,184,828,865,292,1304,1298,10710,20051,21451,11972
37025,NC,"Cabarrus County, NC",106953,99692,7261,6,110300,105406,4894,4,116057,112128,3929,3,227214,231726,235797,646,2571,2689,445,1963,1999,13680,37076,44980,51030
37027,NC,"Caldwell County, NC",34525,31838,2687,7,35257,33497,1760,5,36492,35189,1303,3,80632,80561,80492,183,717,748,255,1235,1229,10763,19073,18646,9645
37029,NC,"Camden County, NC",4437,4195,242,5,4511,4326,185,4,4689,4511,178,3,10407,10816,11088,26,88,92,25,120,118,724,2239,2522,1716
37031,NC,"Carteret County, NC",30267,28400,1867,6,31133,29818,1315,4,32247,31131,1116,3,67724,68718,69380,106,474,497,202,994,1004,4094,12350,19664,15583
37033,NC,"Caswell County, NC",9372,8657,715,7,9408,8899,509,5,9633,9244,389,4,22699,22701,22614,41,175,183,84,349,354,2922,5863,5364,2521
37035,NC,"Catawba County, NC",75617,69671,5946,7,76846,73221,3625,4,79678,76941,2737,3,160892,161821,163462,424,1608,1684,434,2111,2136,15006,32965,36484,26662
37037,NC,"Chatham County, NC",34890,33056,1834,5,35672,34339,1333,3,37436,36279,1157,3,76670,78111,79864,196,643,663,212,893,881,5818,10851,13740,24865
37039,NC,"Cherokee County, NC",10633,9802,831,7,10586,10045,541,5,11127,10680,447,4,28858,29195,29512,52,239,251,91,465,470,2240,7249,7587,4970
37041,NC,"Chowan County, NC",5289,4971,318,6,5488,5210,278,5,5813,5581,232,4,13701,13791,13940,37,142,145,42,230,242,1622,3300,3190,2367
37043,NC,"Clay County, NC",3966,3676,290,7,3958,3757,201,5,4190,4023,167,4,11142,11350,11614,21,87,88,37,178,173,939,2111,3098,2271
37045,NC,"Cleveland County, NC",47015,43390,3625,7,47678,45125,2553,5,49133,47245,1888,3,99799,100318,100670,262,1099,1155,326,1533,1564,9305,23769,22201,12887
37047,NC,"Columbus County, NC",21890,20147,1743,8,22322,20918,1404,6,23653,22648,1005,4,50487,49953,49885,127,579,608,239,903,897,5801,13275,12170,5112
37049,NC,"Craven County, NC",39747,37192,2555,6,40946,39000,1946,4,42137,40585,1552,3,100646,100277,100874,370,1250,1316,298,1419,1414,6940,17560,25662,17226
37051,NC,"Cumberland County, NC",123440,112009,11431,9,125488,116860,8628,6,127747,121211,6536,5,334391,337249,336699,1304,5101,5342,761,3229,3259,16602,55060,81709,53574
37053,NC,"Currituck County, NC",14025,13174,851,6,14240,13645,595,4,14714,14202,512,3,28401,29714,31015,85,314,322,65,305,301,1530,6175,6918,5152
37055,NC,"Dare County, NC",19065,17205,1860,9,19655,18487,1168,5,20014,19157,857,4,37032,37889,37956,80,317,326,85,422,430,1296,6115,9063,11063
37057,NC,"Davidson County, NC",77487,72119,5368,6,78821,75166,3655,4,81618,78764,2854,3,169196,170794,172586,425,1718,1791,529,2295,2302,16811,38289,40403,22778
37059,NC,"Davie County, NC",19722,18414,1308,6,20062,19183,879,4,20811,20107,704,3,42895,43614,44090,114,393,408,117,586,578,2972,9872,9548,7930
37061,NC,"Duplin County, NC",24039,22712,1327,5,24152,23060,1092,4,24724,23819,905,3,48657,48606,48990,174,700,740,201,710,715,6863,10695,10958,5254
37063,NC,"Durham County, NC",169008,158365,10643,6,171066,163761,7305,4,178905,173231,5674,3,325561,329699,332680,986,4058,4262,642,2589,2583,22320,38304,48636,112470
37065,NC,"Edgecombe County, NC",19948,17873,2075,10,20322,18605,1717,8,20272,18947,1325,6,48777,48370,48301,148,592,616,172,853,851,5320,13184,10031,6020
37067,NC,"Forsyth County, NC",179835,166784,13051,7,182861,173726,9135,5,189065,182052,7013,3,383166,386172,389157,1071,4300,4497,930,4317,4278,27441,64200,75888,88175
37069,NC,"Franklin County, NC",30695,28658,2037,6,32085,30545,1540,4,34010,32772,1238,3,69115,71798,74539,184,766,802,169,751,758,6366,14166,15999,10638
37071,NC,"Gaston County, NC",106574,98193,8381,7,109532,103827,5705,5,114660,110448,4212,3,228514,231337,234215,649,2573,2698,642,2937,2970,20864,47150,52351,36475
37073,NC,"Gates County, NC",4871,4596,275,5,4973,4753,220,4,5130,4952,178,3,10448,10403,10383,15,96,96,36,152,154,822,3173,2877,847
37075,NC,"Graham County, NC",2982,2690,292,9,3006,2798,208,6,2947,2789,158,5,8035,8008,7980,27,83,85,30,141,138,1015,2091,1920,787
37077,NC,"Granville County, NC",28842,27193,1649,5,29237,28036,1201,4,30300,29338,962,3,61060,61408,61903,130,602,631,163,713,703,6019,13189,13877,10087
37079,NC,"Greene County, NC",9211,8700,511,5,9317,8924,393,4,9558,9248,310,3,20440,20261,20211,37,201,205,58,258,254,3259,4782,4957,1566
37081,NC,"Guilford County, NC",251807,230764,21043,8,253775,239373,14402,5,260141,249479,10662,4,539498,542756,546101,1496,5780,6038,1290,5589,5599,35186,82609,107379,133446
37083,NC,"Halifax County, NC",19391,17646,1745,9,19136,17708,1428,7,19230,18163,1067,5,48521,48377,47848,125,527,552,191,832,833,7062,12996,9841,5174
37085,NC,"Harnett County, NC",51458,47678,3780,7,52926,50080,2846,5,55036,52781,2255,4,133779,135669,138832,455,1839,1925,319,1284,1286,10048,25222,31721,19981
37087,NC,"Haywood County, NC",28035,25967,2068,7,28989,27737,1252,4,30190,29225,965,3,62223,62504,62609,125,511,536,203,1011,1015,4767,12517,16260,12876
37089,NC,"Henderson County, NC",51228,47758,3470,6,53222,51013,2209,4,55509,53751,1758,3,116541,116988,118106,250,989,1029,402,1717,1697,7221,21705,28867,28493
37091,NC,"Hertford County, NC",8687,8095,592,6,8495,7932,563,6,8516,8079,437,5,21470,21172,20875,48,190,192,77,369,367,2506,5519,4897,2518
37093,NC,"Hoke County, NC",19444,17809,1635,8,19882,18595,1287,6,20291,19293,998,4,52240,53235,53787,201,888,928,110,451,457,4130,9580,13275,6675
37095,NC,"Hyde County, NC",1745,1567,178,10,1751,1635,116,6,1775,1675,100,5,4551,4625,4576,8,37,37,16,71,76,770,1264,1181,403
37097,NC,"Iredell County, NC",87510,81253,6257,7,90134,85931,4203,4,94600,91399,3201,3,187683,192227,195897,443,1890,1974,465,1938,1984,11346,34436,41219,40235
37099,NC,"Jackson County, NC",19123,17695,1428,7,19391,18493,898,4,19689,18940,749,3,42231,42520,42955,73,314,325,109,493,490,3001,8087,8669,7973
37101,NC,"Johnston County, NC",97425,91412,6013,6,101791,97424,4367,4,108081,104509,3572,3,217787,227313,234778,606,2581,2710,442,1902,1908,15900,38991,51411,34682
37103,NC,"Jones County, NC",4043,3816,227,5,4178,3998,180,4,4318,4171,147,3,9147,9217,9233,22,84,87,38,171,171,1149,2493,2257,1020
37105,NC,"Lee County, NC",25103,23122,1981,7,25194,23809,1385,5,26093,24996,1097,4,63428,64097,65476,206,770,798,170,764,751,6115,11309,16211,8852
37107,NC,"Lenoir County, NC",26675,25059,1616,6,26833,25477,1356,5,27655,26640,1015,3,55050,54693,54633,156,653,683,203,952,916,7303,13199,12589,5370
37109,NC,"Lincoln County, NC",42659,39918,2741,6,44077,42258,1819,4,46383,44923,1460,3,87206,89870,93095,220,872,911,250,1066,1050,6855,18770,21113,14964
37111,NC,"McDowell County, NC",19889,18525,1364,6,19906,18991,915,4,20269,19565,704,3,44580,44586,44753,99,386,400,132,657,665,4756,10663,11210,5947
37113,NC,"Macon County, NC",14939,13950,989,6,15300,14640,660,4,16018,15461,557,3,37092,37488,38065,78,314,326,110,582,578,3066,8834,8997,6589
37115,NC,"Madison County, NC",9279,8648,631,6,9657,9236,421,4,10078,9733,345,3,21228,21645,21768,46,186,189,57,307,310,1605,4794,4110,4879
37117,NC,"Martin County, NC",8607,8023,584,6,8504,8018,486,5,8588,8207,381,4,21953,21742,21508,61,225,228,103,408,409,2814,5561,5372,2333
37119,NC,"Mecklenburg County, NC",605131,559368,45763,7,622240,591711,30529,4,652142,629309,22833,3,1116788,1125809,1145392,3524,14634,15313,1883,7873,7961,68244,123146,203525,349210
37121,NC,"Mitchell County, NC",5732,5294,438,7,5904,5595,309,5,6011,5761,250,4,14906,14982,15094,33,136,140,49,269,278,1301,3422,3920,2484
37123,NC,"Montgomery County, NC",10952,10233,719,6,10999,10473,526,4,11223,10806,417,3,25719,25853,25894,53,255,265,106,388,376,3200,6089,5789,2983
37125,NC,"Moore County, NC",39462,36638,2824,7,40161,38278,1883,4,42109,40564,1545,3,100267,102952,105531,290,1192,1255,317,1402,1421,5464,14206,22759,28448
37127,NC,"Nash County, NC",41332,37960,3372,8,42216,39540,2676,6,42356,40246,2110,5,95148,95227,95789,250,1026,1071,268,1303,1352,8265,21484,21360,14278
37129,NC,"New Hanover County, NC",118045,109652,8393,7,122553,117253,5300,4,129545,125298,4247,3,226307,229930,234921,516,2091,2179,545,2478,2505,9653,29894,49289,66545
37131,NC,"Northampton County, NC",7201,6680,521,7,7169,6716,453,6,7248,6896,352,4,17435,17093,16779,48,167,168,93,357,355,2592,4630,4113,2270
37133,NC,"Onslow County, NC",62685,58183,4502,7,65582,62160,3422,5,68204,65295,2909,4,204937,204660,207298,897,3729,3908,339,1481,1512,8951,32215,40594,27000
37135,NC,"Orange County, NC",76140,72149,3991,5,77576,74759,2817,3,81502,79031,2471,3,143583,148610,150477,290,1132,1185,219,1009,999,5787,11847,18009,56351
37137,NC,"Pamlico County, NC",5145,4863,282,5,5328,5095,233,4,5506,5307,199,3,12303,12347,12381,25,86,89,41,206,206,1013,3002,3428,2292
37139,NC,"Pasquotank County, NC",16053,14895,1158,7,16254,15363,891,5,16748,16002,746,4,40577,40746,40938,113,457,478,133,550,534,2968,8012,9505,7078
37141,NC,"Pender County, NC",27772,25997,1775,6,29034,27780,1254,4,30746,29684,1062,3,60642,63072,65737,148,622,651,152,708,724,4495,11156,14369,12249
37143,NC,"Perquimans County, NC",4721,4404,317,6,4822,4559,263,5,4976,4753,223,4,13016,13126,13210,24,111,113,46,232,224,1342,2835,3620,1991
37145,NC,"Person County, NC",17818,16547,1271,7,18038,17109,929,5,18813,18102,711,3,39187,39172,39386,106,439,450,115,568,560,3402,9554,10025,4902
37147,NC,"Pitt County, NC",85465,79775,5690,6,84927,80446,4481,5,88143,84546,3597,4,170378,172273,173542,448,2013,2109,382,1683,1683,10539,25535,34308,34103
37149,NC,"Polk County, NC",8701,8167,534,6,9036,8605,431,4,9365,9007,358,3,19383,19691,19986,24,130,136,76,350,365,1113,3874,5045,5116
37151,NC,"Randolph County, NC",62718,58195,4523,7,63412,60378,3034,4,65327,62948,2379,3,144418,145109,146043,388,1509,1574,479,1965,1980,16065,34866,32803,16028
37153,NC,"Richmond County, NC",16136,14683,1453,9,16301,15115,1186,7,16960,16104,856,5,42916,42842,42778,144,565,584,147,682,706,5097,9264,9893,5160
37155,NC,"Robeson County, NC",48182,43995,4187,8,47939,44307,3632,7,48162,45517,2645,5,116305,116229,116663,380,1757,1847,427,1777,1844,16966,25587,23376,10875
37157,NC,"Rockingham County, NC",38076,34964,3112,8,38448,36292,2156,5,39464,37831,1633,4,91188,91260,91957,245,884,918,329,1505,1500,10667,22272,22577,10223
37159,NC,"Rowan County, NC",62957,58017,4940,7,64675,61390,3285,5,67728,65277,2451,3,147148,148012,149645,408,1578,1650,466,2032,2084,13220,33154,34313,20023
37161,NC,"Rutherford County, NC",23711,21537,2174,9,24035,22475,1560,6,24807,23634,1173,4,64479,64618,64963,149,620,653,213,1088,1093,6752,15031,15830,9008
37163,NC,"Sampson County, NC",27502,25921,1581,5,27695,26416,1279,4,28641,27583,1058,3,59078,59080,59120,189,775,818,164,833,846,7250,13975,12783,5859
37165,NC,"Scotland County, NC",10997,9693,1304,11,11039,9995,1044,9,11189,10474,715,6,34141,34175,34162,86,377,401,111,552,532,4324,7788,7499,3554
37167,NC,"Stanly County, NC",28819,27029,1790,6,29472,28162,1310,4,30815,29799,1016,3,62638,63108,64153,136,654,694,211,890,908,6086,14259,15462,7824
37169,NC,"Stokes County, NC",20481,19190,1291,6,20929,20023,906,4,21702,20978,724,3,44565,44641,45175,112,396,410,154,702,703,4490,13280,10457,4579
37171,NC,"Surry County, NC",31664,29525,2139,6,31912,30488,1424,4,32725,31600,1125,3,71372,71196,71403,168,726,760,226,1194,1185,9604,14503,16864,9612
37173,NC,"Swain County, NC",6732,6169,563,8,6790,6477,313,4,7186,6953,233,3,14099,14149,13967,40,156,169,48,255,257,1444,3114,3035,2067
37175,NC,"Transylvania County, NC",13728,12899,829,6,14130,13536,594,4,14744,14237,507,3,33046,33255,33355,57,237,252,105,513,504,2023,6105,8043,9057
37177,NC,"Tyrrell County, NC",1232,1119,113,9,1283,1194,89,6,1311,1243,68,5,3239,3377,3365,11,38,33,14,55,53,627,1018,698,296
37179,NC,"Union County, NC",119125,112164,6961,5,123609,118702,4907,4,130308,126207,4101,3,239443,244260,249070,573,2348,2451,383,1772,1826,14938,35054,44265,56982
37181,NC,"Vance County, NC",16519,14876,1643,9,16627,15312,1315,7,16801,15825,976,5,42535,42103,42138,135,535,563,181,676,678,4495,10281,9165,4939
37183,NC,"Wake County, NC",571230,535082,36148,6,594548,570431,24117,4,631370,612045,19325,3,1130685,1152357,1175021,3042,12654,13251,1549,7066,7110,47387,108711,182377,409097
37185,NC,"Warren County, NC",6312,5703,609,9,6371,5875,496,7,6376,5972,404,6,18598,18791,18713,45,168,175,85,320,318,1990,5460,4367,2125
37187,NC,"Washington County, NC",4242,3902,340,8,4271,3974,297,7,4330,4108,222,5,10976,10909,10828,41,113,120,45,208,205,1311,2854,2809,995
37189,NC,"Watauga County, NC",27026,25363,1663,6,28198,27127,1071,3,29393,28438,955,3,54117,54962,55089,70,301,316,95,449,453,2195,6686,8727,14070
37191,NC,"Wayne County, NC",49607,46479,3128,6,50341,47751,2590,5,50743,48688,2055,4,117266,116866,117286,356,1541,1625,411,1605,1612,11071,23258,27871,15968
37193,NC,"Wilkes County, NC",27421,25577,1844,6,27025,25716,1309,4,27241,26199,1042,3,65904,65818,65784,161,664,693,233,1038,1052,9024,15451,15429,8027
37195,NC,"Wilson County, NC",33521,30599,2922,8,33334,31080,2254,6,33724,31999,1725,5,78807,78283,78449,233,873,912,280,1161,1143,9600,17705,15908,10633
37197,NC,"Yadkin County, NC",16813,15639,1174,7,17029,16290,739,4,17671,17081,590,3,37246,37258,37463,111,352,366,115,553,552,3813,9419,9581,3704
37199,NC,"Yancey County, NC",7904,7388,516,6,7982,7630,352,4,8237,7942,295,3,18490,18776,18811,55,175,183,66,285,287,1654,4852,4440,2793
38000,ND,North Dakota,409799,389415,20384,5,408900,396364,12536,3,414311,405580,8731,2,779518,777934,779261,2563,10058,10164,1758,7816,7365,33831,131400,182014,156652
38001,ND,"Adams County, ND",1006,970,36,3,976,948,28,2,955,934,21,2,2187,2152,2115,7,23,24,11,36,34,115,591,571,302
38003,ND,"Barnes County, ND",5192,4997,195,3,5210,5072,138,2,5226,5110,116,2,10847,10812,10758,23,95,95,35,165,162,392,2344,2624,2216
38005,ND,"Benson County, ND",2310,2157,153,6,2308,2212,96,4,2347,2279,68,2,5931,5778,5770,28,118,116,20,107,110,455,1000,1287,662
38007,ND,"Billings County, ND",437,421,16,3,456,445,11,2,457,448,9,2,933,961,1018,0,9,10,0,5,8,35,227,178,160
38009,ND,"Bottineau County, ND",2972,2817,155,5,2997,2878,119,4,3001,2912,89,3,6384,6437,6376,13,71,76,13,77,72,299,1271,1777,1090
38011,ND,"Bowman County, ND",1629,1576,53,3,1602,1568,34,2,1557,1530,27,1,2984,2902,2894,10,32,32,11,45,41,202,737,754,393
38013,ND,"Burke County, ND",1035,982,53,5,1056,1018,38,3,1042,1021,21,2,2208,2173,2155,4,24,25,1,22,21,90,450,643,329
38015,ND,"Burleigh County, ND",51100,48954,2146,4,52074,50705,1369,2,52386,51373,1013,1,98594,98967,99280,308,1169,1169,209,977,935,3371,15232,22791,24537
38017,ND,"Cass County, ND",105849,101355,4494,4,108123,105487,2636,2,110429,108482,1947,1,184874,189293,192734,593,2427,2447,388,1428,1336,5512,21855,40283,48501
38019,ND,"Cavalier County, ND",1908,1844,64,3,1890,1841,49,2,1842,1797,45,2,3694,3664,3597,11,45,46,17,59,54,146,718,1121,658
38021,ND,"Dickey County, ND",2308,2234,74,3,2286,2234,52,2,2238,2199,39,1,4971,4905,4923,16,62,62,16,82,75,254,920,1269,825
38023,ND,"Divide County, ND",1439,1395,44,3,1450,1420,30,2,1442,1423,19,1,2212,2191,2187,9,21,22,7,26,24,114,392,695,367
38025,ND,"Dunn County, ND",3147,3007,140,4,3084,2999,85,2,3215,3172,43,1,4100,4025,4015,14,75,77,11,38,36,315,1010,1019,573
38027,ND,"Eddy County, ND",1201,1147,54,4,1200,1161,39,3,1207,1172,35,2,2320,2322,2314,5,29,29,10,43,41,176,532,570,418
38029,ND,"Emmons County, ND",1488,1418,70,4,1482,1424,58,3,1456,1393,63,4,3293,3262,3250,10,32,31,17,58,54,279,906,844,445
38031,ND,"Foster County, ND",1556,1504,52,3,1522,1486,36,2,1527,1495,32,2,3388,3362,3378,11,41,42,9,55,50,183,667,996,549
38033,ND,"Golden Valley County, ND",861,835,26,3,854,834,20,2,855,841,14,1,1720,1757,1744,4,16,17,5,17,17,80,368,581,316
38035,ND,"Grand Forks County, ND",37150,35493,1657,4,37290,36282,1008,2,37733,37021,712,1,73126,72512,72413,229,878,889,138,583,544,2016,9335,16428,15698
38037,ND,"Grant County, ND",1198,1166,32,2,1245,1217,28,2,1221,1197,24,2,2289,2311,2243,7,21,21,9,40,41,116,595,665,366
38039,ND,"Griggs County, ND",1023,993,30,2,1035,1010,25,2,1019,997,22,2,2297,2284,2252,2,24,27,12,33,35,126,490,547,496
38041,ND,"Hettinger County, ND",1391,1338,53,3,1397,1359,38,2,1402,1378,24,1,2467,2422,2406,6,28,27,7,43,35,210,623,707,311
38043,ND,"Kidder County, ND",1294,1231,63,4,1327,1270,57,4,1323,1271,52,3,2387,2361,2393,6,24,23,6,30,33,180,567,581,313
38045,ND,"LaMoure County, ND",2063,2010,53,2,2064,2025,39,1,2108,2069,39,1,4101,4095,4098,26,54,54,10,52,45,343,867,1041,685
38047,ND,"Logan County, ND",861,834,27,3,874,852,22,2,873,854,19,2,1890,1882,1855,7,22,21,3,27,25,136,405,494,304
38049,ND,"McHenry County, ND",3109,2945,164,5,3157,3042,115,3,3159,3057,102,3,5311,5239,5189,11,58,58,18,85,79,300,1266,1465,799
38051,ND,"McIntosh County, ND",1098,1063,35,3,1100,1068,32,2,1072,1049,23,2,2511,2506,2475,2,32,34,18,56,58,307,692,676,323
38053,ND,"McKenzie County, ND",9484,8784,700,7,8665,8277,388,4,9183,9009,174,1,14776,13851,13908,77,239,242,16,103,86,561,2679,3105,2001
38055,ND,"McLean County, ND",4829,4619,210,4,4739,4592,147,3,4815,4668,147,3,9756,9794,9824,17,95,96,28,132,120,538,2258,2735,1503
38057,ND,"Mercer County, ND",3636,3434,202,5,3702,3558,144,3,3636,3517,119,3,8348,8330,8333,21,81,82,15,87,81,576,1566,2532,1252
38059,ND,"Morton County, ND",16894,16068,826,4,17168,16616,552,3,17240,16815,425,2,33313,33560,33710,87,425,435,85,393,368,1821,6166,8499,6181
38061,ND,"Mountrail County, ND",6908,6559,349,5,6502,6312,190,2,6436,6337,99,1,9807,9593,9290,44,168,170,21,102,104,643,1991,2181,1308
38063,ND,"Nelson County, ND",1397,1336,61,4,1415,1371,44,3,1461,1418,43,2,2993,3044,2995,6,21,20,15,56,53,149,663,865,547
38065,ND,"Oliver County, ND",872,828,44,5,880,851,29,3,889,860,29,3,1869,1873,1856,6,18,17,3,17,15,80,364,567,262
38067,ND,"Pembina County, ND",3392,3206,186,5,3336,3201,135,4,3261,3151,110,3,6823,6775,6763,19,77,78,12,84,83,469,1549,1876,1075
38069,ND,"Pierce County, ND",1708,1637,71,4,1690,1642,48,2,1666,1623,43,2,3968,3943,3942,10,33,34,9,64,58,198,855,973,824
38071,ND,"Ramsey County, ND",5731,5484,247,4,5780,5622,158,2,5678,5550,128,2,11573,11598,11515,36,136,139,42,156,146,703,2142,3027,2007
38073,ND,"Ransom County, ND",2889,2775,114,3,2724,2665,59,2,2681,2635,46,1,5690,5667,5640,13,55,57,23,85,81,296,1499,1324,841
38075,ND,"Renville County, ND",1229,1170,59,4,1213,1179,34,2,1224,1200,24,2,2273,2262,2220,4,23,22,5,37,35,98,484,588,356
38077,ND,"Richland County, ND",8625,8302,323,3,8743,8540,203,2,8845,8676,169,1,16527,16570,16580,50,184,182,29,146,146,795,2698,4715,2397
38079,ND,"Rolette County, ND",4767,4142,625,13,4742,4328,414,8,4756,4440,316,6,12195,12086,11933,67,206,205,38,191,188,964,1864,3099,1240
38081,ND,"Sargent County, ND",2804,2687,117,4,2396,2342,54,2,2327,2287,40,1,3836,3819,3795,5,38,40,17,48,47,170,952,1095,555
38083,ND,"Sheridan County, ND",681,642,39,5,667,638,29,4,662,645,17,2,1267,1270,1295,5,10,9,4,20,19,132,420,349,146
38085,ND,"Sioux County, ND",1195,1149,46,3,1222,1185,37,3,1232,1200,32,2,3882,3759,3711,16,67,66,14,59,60,323,732,765,287
38087,ND,"Slope County, ND",394,382,12,3,361,352,9,2,341,332,9,2,695,686,672,0,7,5,2,3,3,52,173,203,152
38089,ND,"Stark County, ND",18374,17082,1292,7,17605,16923,682,3,18115,17772,343,1,33828,33059,32803,142,519,526,62,285,274,1649,6753,7208,5466
38091,ND,"Steele County, ND",959,932,27,2,942,919,23,2,951,932,19,2,1787,1798,1788,7,24,23,3,25,22,50,321,564,393
38093,ND,"Stutsman County, ND",10535,10181,354,3,10463,10197,266,2,10668,10450,218,2,21556,21591,21487,46,203,206,56,275,254,1270,5380,4739,3570
38095,ND,"Towner County, ND",1153,1122,31,2,1156,1124,32,2,1128,1101,27,2,2147,2133,2064,6,24,23,6,35,33,194,504,684,244
38097,ND,"Traill County, ND",4466,4310,156,3,4475,4361,114,2,4512,4422,90,2,7988,7990,7958,24,84,86,22,108,105,311,1369,2116,1657
38099,ND,"Walsh County, ND",5165,4939,226,4,5312,5110,202,3,5280,5114,166,3,10524,10479,10438,26,115,117,30,143,131,955,2523,2603,1340
38101,ND,"Ward County, ND",32017,30153,1864,5,32114,30970,1144,3,32400,31669,731,2,69923,69437,68870,258,1047,1066,144,658,601,2722,13187,15115,12895
38103,ND,"Wells County, ND",1910,1830,80,4,1916,1849,67,3,1926,1866,60,3,3971,3905,3930,10,37,36,13,66,60,252,1128,925,646
38105,ND,"Williams County, ND",23165,20978,2187,9,20920,19785,1135,5,21917,21423,494,2,41184,38487,38109,199,692,708,43,249,227,2108,7120,8955,5871
39000,OH,Ohio,5754698,5280930,473768,8,5728769,5434815,293954,5,5741277,5510327,230950,4,11797517,11764342,11756058,32341,128220,129529,33744,146833,149072,715751,2636855,2326518,2398329
39001,OH,"Adams County, OH",10896,9880,1016,9,10940,10244,696,6,10960,10371,589,5,27440,27513,27420,68,335,334,91,479,487,3068,7934,4790,2998
39003,OH,"Allen County, OH",47944,43816,4128,8,47384,44646,2738,5,46700,44728,1972,4,102107,101792,101115,293,1187,1197,286,1369,1395,6084,27706,21795,13139
39005,OH,"Ashland County, OH",26353,24640,1713,6,26217,25065,1152,4,25995,24995,1000,3,52468,52340,52181,136,532,544,135,714,732,3628,14761,8973,7807
39007,OH,"Ashtabula County, OH",43808,40144,3664,8,43150,40760,2390,5,42977,41083,1894,4,97516,97452,97014,261,1021,1028,313,1441,1474,9356,29835,19201,10372
39009,OH,"Athens County, OH",26427,24404,2023,7,25785,24344,1441,5,26150,24896,1254,4,62371,59086,58979,116,466,471,128,630,635,3259,11222,9177,12219
39011,OH,"Auglaize County, OH",24579,22883,1696,6,24263,23354,909,3,24000,23259,741,3,46461,46240,45948,140,535,541,132,627,626,1982,13260,9828,6288
39013,OH,"Belmont County, OH",28597,25684,2913,10,27774,26061,1713,6,27182,25781,1401,5,66283,65895,65509,150,595,593,244,1070,1115,4181,22782,14469,7892
39015,OH,"Brown County, OH",19308,17692,1616,8,19372,18331,1041,5,19528,18648,880,4,43671,43690,43680,132,451,455,147,661,685,4053,13926,8096,4450
39017,OH,"Butler County, OH",194249,180054,14195,7,195244,186424,8820,4,197439,190433,7006,3,390872,387791,388420,1167,4270,4321,957,4193,4285,21101,81168,67439,79165
39019,OH,"Carroll County, OH",12876,11734,1142,8,12714,11995,719,5,12588,12046,542,4,26697,26671,26659,75,240,239,94,409,414,1991,9276,5376,2732
39021,OH,"Champaign County, OH",19845,18420,1425,7,19319,18458,861,4,19186,18469,717,3,38734,38782,38709,103,396,395,105,507,509,2381,12076,8046,4527
39023,OH,"Clark County, OH",62813,57680,5133,8,62613,59269,3344,5,62683,60114,2569,4,135879,135747,134831,381,1493,1507,431,2115,2182,10474,34950,30064,17544
39025,OH,"Clermont County, OH",106161,98818,7343,6,107017,102360,4657,4,108269,104425,3844,3,208738,209867,210805,524,2181,2201,488,2371,2402,13619,45879,42099,42441
39027,OH,"Clinton County, OH",17733,16242,1491,8,17874,16888,986,5,17858,17076,782,4,42023,42100,41964,130,474,486,127,554,578,2490,10788,9362,5683
39029,OH,"Columbiana County, OH",47187,42730,4457,9,45667,43028,2639,5,44719,42653,2066,4,101634,101250,100511,213,980,984,389,1599,1612,7732,33268,21172,11546
39031,OH,"Coshocton County, OH",14136,12871,1265,8,13757,12949,808,5,13666,12999,667,4,36578,36614,36571,111,424,431,117,513,537,3981,10785,6244,4322
39033,OH,"Crawford County, OH",18588,16843,1745,9,17997,16942,1055,5,17707,16863,844,4,42003,41797,41522,117,441,447,136,695,721,2948,13680,8323,4630
39035,OH,"Cuyahoga County, OH",601373,537911,63462,10,596287,558946,37341,6,599648,570341,29307,4,1262523,1247808,1236041,3292,13033,13169,3853,16204,16360,82746,243671,258545,306407
39037,OH,"Darke County, OH",25714,23974,1740,6,25591,24581,1010,3,25536,24631,905,3,51897,51645,51529,146,578,578,159,712,737,3085,16249,10102,5894
39039,OH,"Defiance County, OH",17784,16321,1463,8,17531,16701,830,4,17374,16688,686,3,38254,38216,38187,113,413,417,98,479,489,2060,10508,8540,5007
39041,OH,"Delaware County, OH",112387,106320,6067,5,114332,110170,4162,3,115832,112373,3459,3,215139,221186,226296,503,2083,2094,353,1509,1545,3893,22603,33380,79579
39043,OH,"Erie County, OH",36586,32768,3818,10,37039,34678,2361,6,36592,34810,1782,4,75475,74918,74501,173,683,692,276,1158,1177,4419,19362,17033,13750
39045,OH,"Fairfield County, OH",78771,73515,5256,6,79614,76120,3494,4,80488,77688,2800,3,159443,161182,162898,400,1665,1682,402,1754,1804,6869,34603,32860,32162
39047,OH,"Fayette County, OH",13982,12945,1037,7,13692,13030,662,4,13732,13203,529,3,28971,28929,28839,86,325,322,96,416,429,3122,8995,4782,2918
39049,OH,"Franklin County, OH",701892,648597,53295,7,707069,671944,35125,5,710441,686143,24298,3,1324357,1317560,1321820,4382,17250,17461,3085,12005,12071,75031,210885,230738,361987
39051,OH,"Fulton County, OH",21817,20091,1726,7,21593,20566,1027,4,21627,20758,869,4,42643,42473,42171,117,431,438,115,513,539,2015,12382,9686,5146
39053,OH,"Gallia County, OH",12237,11255,982,8,12057,11368,689,5,12017,11452,565,4,29241,29220,29068,105,365,368,92,452,459,3004,8163,5504,3475
39055,OH,"Geauga County, OH",47006,43834,3172,6,47564,45636,1928,4,48335,46388,1947,4,95347,95649,95469,240,935,938,260,1054,1096,6193,16793,17533,25284
39057,OH,"Greene County, OH",82434,77069,5365,6,81960,78371,3589,4,82069,79128,2941,3,168119,167628,168456,427,1641,1671,412,1907,1939,6735,25627,33974,46347
39059,OH,"Guernsey County, OH",18310,16712,1598,8,17811,16811,1000,5,17712,16841,871,4,38415,38263,38098,105,430,432,128,608,623,3813,11590,7593,3982
39061,OH,"Hamilton County, OH",414064,381365,32699,7,415252,395045,20207,4,418259,403233,15026,3,830320,827501,825037,2579,10189,10329,2231,9313,9330,45008,144656,147482,221380
39063,OH,"Hancock County, OH",41560,38712,2848,6,40877,39174,1703,4,40237,38916,1321,3,74930,74775,74861,219,840,851,171,928,936,3385,18514,15258,14464
39065,OH,"Hardin County, OH",13962,12825,1137,8,13558,12849,709,5,13074,12522,552,4,30724,30446,30416,105,377,379,105,440,461,1793,9325,4578,3089
39067,OH,"Harrison County, OH",6704,6080,624,9,6488,6084,404,6,6446,6128,318,4,14486,14476,14378,44,165,165,52,249,278,1228,5257,2791,1294
39069,OH,"Henry County, OH",13040,11981,1059,8,12745,12081,664,5,12691,12114,577,4,27663,27555,27512,83,299,302,73,385,385,1228,8552,5956,3374
39071,OH,"Highland County, OH",17454,15933,1521,8,17275,16281,994,5,17390,16535,855,4,43359,43423,43391,126,507,507,135,614,627,4801,12527,8020,4154
39073,OH,"Hocking County, OH",12747,11788,959,7,12843,12219,624,4,12989,12457,532,4,28039,28126,27858,74,277,280,75,413,427,2371,8434,6189,2945
39075,OH,"Holmes County, OH",20944,20122,822,3,21388,20785,603,2,21675,21060,615,2,44226,44374,44390,214,813,830,99,420,426,11332,8353,3656,2745
39077,OH,"Huron County, OH",27587,24968,2619,9,27631,26010,1621,5,27703,26291,1412,5,58485,58431,58218,148,640,641,163,778,779,4002,18481,11390,5966
39079,OH,"Jackson County, OH",13166,12010,1156,8,12608,11826,782,6,12309,11697,612,5,32669,32518,32586,77,372,375,110,510,513,2794,10335,5764,3367
39081,OH,"Jefferson County, OH",27533,24741,2792,10,27115,25345,1770,6,27008,25538,1470,5,65171,65111,64330,164,631,635,225,1089,1144,3394,20386,14309,8505
39083,OH,"Knox County, OH",31000,29066,1934,6,30994,29725,1269,4,30872,29794,1078,3,62783,62547,63183,183,744,744,166,793,816,3382,16274,12003,9289
39085,OH,"Lake County, OH",122854,112513,10341,8,122993,116886,6107,5,124629,119276,5353,4,232508,232223,231842,489,2036,2058,611,3073,3097,11693,52584,55194,48445
39087,OH,"Lawrence County, OH",23715,21688,2027,8,23129,21926,1203,5,23268,22189,1079,4,58136,57400,56653,176,617,621,231,1017,1065,4554,18369,11309,6975
39089,OH,"Licking County, OH",90324,84344,5980,6,91141,87373,3768,4,92216,89072,3144,3,178769,179962,181359,464,1884,1895,444,2116,2144,8626,40183,37083,34419
39091,OH,"Logan County, OH",22770,20893,1877,8,22402,21464,938,4,22454,21673,781,3,46106,46129,46040,143,505,516,123,601,615,2294,14236,9667,5718
39093,OH,"Lorain County, OH",152892,137862,15030,9,151656,143185,8471,5,153935,146132,7803,5,313495,314165,316268,806,3179,3203,849,3892,3971,19710,67562,73049,56308
39095,OH,"Lucas County, OH",208882,187181,21701,10,204500,191793,12707,6,202790,193820,8970,4,430834,429360,426643,1319,5010,5062,1496,5624,5697,28873,87399,96387,80858
39097,OH,"Madison County, OH",20540,19298,1242,6,20762,19954,808,3,21029,20354,675,3,43853,44404,43540,107,422,426,109,520,536,3686,12839,8799,6326
39099,OH,"Mahoning County, OH",100445,90135,10310,10,98540,92283,6257,6,98057,93355,4702,4,228005,226443,225636,554,2300,2330,985,3738,3775,14030,61455,47589,40698
39101,OH,"Marion County, OH",28334,26170,2164,7,27819,26496,1323,4,27349,26146,1203,4,65399,65311,64642,173,689,694,204,893,916,4656,20500,15030,6083
39103,OH,"Medina County, OH",95697,88426,7271,7,95930,91873,4057,4,97626,93708,3918,4,182636,183338,183512,385,1649,1666,434,1953,1981,6291,38679,37889,44654
39105,OH,"Meigs County, OH",8998,8119,879,9,8763,8181,582,6,8590,8088,502,5,22149,22085,21969,47,208,207,76,372,380,2355,7248,4269,1965
39107,OH,"Mercer County, OH",23454,22188,1266,5,22855,22132,723,3,22779,22165,614,2,42526,42369,42348,164,625,631,115,521,519,1969,12167,7973,5666
39109,OH,"Miami County, OH",53900,50097,3803,7,53209,50911,2298,4,53343,51445,1898,3,108950,109386,110247,293,1140,1152,261,1428,1443,5114,28342,23331,18235
39111,OH,"Monroe County, OH",5674,5066,608,10,5281,4892,389,7,5130,4802,328,6,13349,13324,13234,35,139,139,59,224,217,998,4908,2675,1239
39113,OH,"Montgomery County, OH",251147,229213,21934,8,246953,233108,13845,5,245512,235457,10055,4,537093,536169,533892,1495,6100,6153,1640,7547,7573,32966,102217,124990,107302
39115,OH,"Morgan County, OH",6702,6082,620,9,6743,6321,422,6,6784,6423,361,5,13756,13689,13668,35,148,149,49,242,251,1538,4532,2883,1092
39117,OH,"Morrow County, OH",16751,15541,1210,7,16868,16100,768,4,17064,16401,663,3,34973,35197,35339,92,363,373,81,395,404,2694,11114,6944,3652
39119,OH,"Muskingum County, OH",40322,37175,3147,7,40472,38388,2084,5,40606,38857,1749,4,86450,86574,86113,264,989,1000,258,1162,1207,6015,25262,17047,10782
39121,OH,"Noble County, OH",4650,4198,452,9,4623,4310,313,6,4589,4313,276,6,14086,14312,14335,36,149,147,40,164,164,1614,5592,2260,1308
39123,OH,"Ottawa County, OH",20634,18747,1887,9,20555,19300,1255,6,20489,19414,1075,5,40287,40156,39978,86,292,297,150,618,632,2329,10823,9387,7929
39125,OH,"Paulding County, OH",8710,8057,653,7,8590,8217,373,4,8669,8365,304,3,18805,18886,18757,48,218,220,44,235,233,1335,5847,3720,2105
39127,OH,"Perry County, OH",15830,14481,1349,8,15879,14989,890,5,16003,15299,704,4,35448,35454,35480,109,391,397,100,479,484,2729,11707,6740,3277
39129,OH,"Pickaway County, OH",26334,24521,1813,6,26579,25383,1196,4,26881,25886,995,3,58646,58770,60023,168,622,628,191,727,761,5228,16723,10882,7980
39131,OH,"Pike County, OH",10893,9866,1027,9,10860,10171,689,6,10991,10433,558,5,27069,27059,27005,82,331,332,101,455,462,2798,8744,4500,2766
39133,OH,"Portage County, OH",85433,79163,6270,7,84702,80677,4025,4,84528,81276,3252,3,161833,158978,161745,326,1314,1338,424,1845,1873,8067,39039,27092,31890
39135,OH,"Preble County, OH",21067,19631,1436,6,21483,20610,873,4,21848,21113,735,3,41001,40894,40596,92,391,392,110,588,612,2495,12839,8229,5296
39137,OH,"Putnam County, OH",18587,17543,1044,5,18789,18143,646,3,18852,18281,571,3,34395,34353,34334,98,408,415,89,396,405,1242,9078,6911,5668
39139,OH,"Richland County, OH",51842,47161,4681,9,51291,48416,2875,5,50555,48271,2284,4,124962,125327,125319,341,1357,1371,355,1761,1821,10043,35288,26103,15501
39141,OH,"Ross County, OH",35297,32461,2836,8,35054,33343,1711,4,35048,33702,1346,3,77064,76540,76606,191,782,791,254,1107,1160,6134,24130,15217,9225
39143,OH,"Sandusky County, OH",30079,27629,2450,8,30237,28648,1589,5,29924,28515,1409,4,58865,58763,58667,156,587,594,173,804,838,3069,17511,13341,7518
39145,OH,"Scioto County, OH",29176,26623,2553,8,29231,27411,1820,6,29211,27729,1482,5,73844,73012,72194,189,737,742,306,1321,1347,7256,22305,13726,8487
39147,OH,"Seneca County, OH",27197,24984,2213,8,26631,25358,1273,4,26246,25149,1097,4,55051,54954,54632,153,594,602,172,743,770,2605,16611,11420,6682
39149,OH,"Shelby County, OH",24007,22146,1861,7,23752,22751,1001,4,23517,22690,827,3,48138,48030,47671,140,616,622,134,627,630,3334,13197,9469,6123
39151,OH,"Stark County, OH",183740,168819,14921,8,182086,172558,9528,5,180832,173548,7284,4,374486,373659,372657,948,3888,3930,1253,5414,5454,20179,100003,79996,61781
39153,OH,"Summit County, OH",268162,245748,22414,8,264828,250394,14434,5,263201,252394,10807,4,539792,537247,535882,1378,5442,5485,1748,7084,7100,28145,112545,111344,129504
39155,OH,"Trumbull County, OH",84914,76039,8875,10,83220,77881,5339,6,82829,78741,4088,4,201672,201444,200643,495,1956,1975,756,3233,3271,15628,63958,37389,27908
39157,OH,"Tuscarawas County, OH",44594,41213,3381,7,44322,42257,2065,4,44482,42784,1698,3,93183,92608,91937,265,1103,1106,300,1353,1390,7479,29489,15526,11810
39159,OH,"Union County, OH",29591,27868,1723,5,29914,28848,1066,3,30281,29368,913,3,63089,65110,66898,154,692,703,111,492,503,2355,12840,10799,15795
39161,OH,"Van Wert County, OH",14781,13738,1043,7,14461,13885,576,4,14335,13855,480,3,28919,28776,28769,89,328,328,89,397,410,1412,8874,6254,3305
39163,OH,"Vinton County, OH",5617,5098,519,9,5482,5141,341,6,5398,5129,269,5,12804,12707,12565,36,130,127,41,216,220,1790,3914,2172,1185
39165,OH,"Warren County, OH",120024,112349,7675,6,121228,116354,4874,4,122794,118767,4027,3,243201,246822,249778,559,2421,2426,480,2305,2352,8757,41882,39967,71608
39167,OH,"Washington County, OH",26894,24573,2321,8,26602,25113,1489,5,26568,25315,1253,4,59644,59459,58901,126,550,559,199,852,887,3691,16619,14099,8509
39169,OH,"Wayne County, OH",60482,56910,3572,5,60037,57848,2189,3,59887,57993,1894,3,116906,116129,116559,358,1386,1398,339,1472,1485,10680,29573,18535,17954
39171,OH,"Williams County, OH",18844,17380,1464,7,18369,17572,797,4,18105,17488,617,3,37077,36743,36652,104,385,392,87,496,503,2147,11082,8835,3762
39173,OH,"Wood County, OH",69437,64522,4915,7,69078,66092,2986,4,69220,66787,2433,3,132248,130331,131592,312,1225,1243,354,1369,1414,4142,24066,24174,29800
39175,OH,"Wyandot County, OH",12934,12035,899,7,12876,12419,457,3,13181,12799,382,2,21861,21704,21567,39,215,220,65,312,321,975,7159,4203,2971
40000,OK,Oklahoma,1841349,1725318,116031,6,1860337,1785703,74634,4,1887040,1830061,56979,3,3964912,3991225,4019800,11579,47369,48107,10380,50720,51390,293373,803726,810500,700142
40001,OK,"Adair County, OK",8319,7823,496,6,8538,8210,328,3,8602,8314,288,3,19451,19479,19576,72,269,274,59,293,305,2448,6027,3032,1363
40003,OK,"Alfalfa County, OK",2753,2650,103,3,2686,2620,66,2,2694,2640,54,2,5708,5681,5637,11,50,50,19,92,96,618,1501,1259,898
40005,OK,"Atoka County, OK",5129,4755,374,7,5015,4766,249,5,5131,4933,198,3,14154,14252,14262,30,145,150,54,219,225,1610,4114,2702,1447
40007,OK,"Beaver County, OK",2576,2506,70,2,2638,2590,48,1,2663,2613,50,1,5029,4999,5016,15,50,51,14,66,64,513,1098,1053,728
40009,OK,"Beckham County, OK",9973,9198,775,7,9744,9310,434,4,10437,10168,269,2,22342,22044,22009,56,250,257,51,321,317,2257,5938,4820,2237
40011,OK,"Blaine County, OK",4388,4118,270,6,4398,4263,135,3,4402,4303,99,2,8702,8523,8409,19,106,108,38,170,170,1076,2226,1957,1068
40013,OK,"Bryan County, OK",22377,21211,1166,5,22088,21327,761,3,23030,22400,630,2,46327,47187,48182,154,567,579,130,661,673,3938,9903,9471,7244
40015,OK,"Caddo County, OK",11927,11203,724,6,12000,11532,468,3,11834,11452,382,3,26900,26441,26198,108,335,338,103,500,506,2631,7940,5068,2713
40017,OK,"Canadian County, OK",77497,72833,4664,6,78558,75914,2644,3,80563,78522,2041,2,155425,161981,169149,469,1853,1878,251,1359,1362,7971,27052,33842,31489
40019,OK,"Carter County, OK",21299,19768,1531,7,21469,20481,988,4,21519,20769,750,3,48036,48324,48510,158,604,617,150,751,764,4116,11684,9858,6465
40021,OK,"Cherokee County, OK",19541,18438,1103,5,20066,19199,867,4,20114,19405,709,3,47090,47631,48098,118,548,555,143,637,644,3526,9696,8598,8059
40023,OK,"Choctaw County, OK",5568,5138,430,7,5962,5640,322,5,5979,5702,277,4,14201,14314,14358,49,187,189,65,282,289,1591,3780,2980,1385
40025,OK,"Cimarron County, OK",1399,1370,29,2,1506,1478,28,1,1604,1582,22,1,2290,2255,2252,5,28,28,4,24,27,218,586,317,457
40027,OK,"Cleveland County, OK",142448,134295,8153,5,144833,139956,4877,3,148449,144665,3784,2,296207,298099,299587,678,2681,2729,562,2579,2580,14988,47144,60423,65059
40029,OK,"Coal County, OK",2281,2121,160,7,2299,2192,107,4,2343,2267,76,3,5284,5319,5313,16,85,86,24,106,110,543,1533,887,629
40031,OK,"Comanche County, OK",47954,44667,3287,6,47903,45857,2046,4,47507,45791,1716,3,121125,122438,123046,370,1709,1736,276,1328,1325,7290,24859,26883,18565
40033,OK,"Cotton County, OK",2712,2516,196,7,2716,2600,116,4,2687,2605,82,3,5535,5467,5477,17,50,50,25,98,98,631,1590,986,645
40035,OK,"Craig County, OK",5801,5479,322,5,5800,5580,220,3,5918,5736,182,3,14136,14176,14123,39,150,151,52,244,248,1300,4051,3101,1445
40037,OK,"Creek County, OK",30989,28908,2081,6,31211,29827,1384,4,31506,30401,1105,3,71837,72186,72699,177,788,799,193,1054,1081,5011,19711,15994,8421
40039,OK,"Custer County, OK",15061,14226,835,5,15235,14718,517,3,15055,14660,395,2,28444,28132,27886,93,326,327,83,420,422,1984,4573,5308,4977
40041,OK,"Delaware County, OK",18417,17416,1001,5,18969,18307,662,3,19922,19338,584,2,40385,40927,41413,79,365,376,175,746,756,4379,11014,8777,5363
40043,OK,"Dewey County, OK",2683,2550,133,5,2679,2602,77,2,2976,2917,59,2,4474,4415,4401,16,56,56,9,77,77,214,1236,863,580
40045,OK,"Ellis County, OK",2136,2037,99,4,2110,2048,62,2,2091,2043,48,2,3739,3731,3657,6,31,32,6,58,64,328,1004,860,494
40047,OK,"Garfield County, OK",26928,25421,1507,5,26764,25793,971,3,26569,25796,773,2,62692,61947,61920,182,829,841,167,888,899,4832,15134,11383,9577
40049,OK,"Garvin County, OK",12730,11918,812,6,12670,12174,496,3,12756,12392,364,2,25645,25738,25713,67,278,283,88,442,448,2055,7671,4738,2902
40051,OK,"Grady County, OK",26358,24700,1658,6,26763,25793,970,3,27390,26640,750,2,54873,55608,56658,153,568,576,136,751,760,3636,14687,10657,8268
40053,OK,"Grant County, OK",2766,2672,94,3,2782,2709,73,2,2766,2713,53,1,4174,4153,4124,13,49,50,12,79,83,253,998,879,663
40055,OK,"Greer County, OK",1873,1729,144,7,1868,1770,98,5,1841,1778,63,3,5493,5483,5547,17,53,53,23,92,96,688,1485,1431,427
40057,OK,"Harmon County, OK",1172,1129,43,3,1183,1151,32,2,1202,1169,33,2,2473,2413,2428,10,31,31,5,50,53,322,583,577,281
40059,OK,"Harper County, OK",1767,1706,61,3,1804,1757,47,2,1799,1763,36,2,3248,3172,3129,4,30,30,8,61,64,247,719,815,515
40061,OK,"Haskell County, OK",4229,3885,344,8,4228,3997,231,5,4176,3996,180,4,11552,11601,11641,27,137,138,39,202,211,1231,3212,2329,1270
40063,OK,"Hughes County, OK",5310,4901,409,7,5205,4927,278,5,5140,4940,200,3,13348,13394,13407,46,160,163,46,247,259,1513,3670,2514,1387
40065,OK,"Jackson County, OK",10594,10152,442,4,10785,10461,324,3,10762,10469,293,2,24736,24720,24556,76,344,351,62,345,334,2188,4377,5562,3930
40067,OK,"Jefferson County, OK",2562,2389,173,6,2489,2386,103,4,2475,2398,77,3,5325,5396,5389,10,53,53,22,113,118,610,1555,965,562
40069,OK,"Johnston County, OK",3754,3461,293,7,3706,3528,178,4,3784,3643,141,3,10241,10357,10406,30,121,125,27,148,150,903,2528,1992,1617
40071,OK,"Kay County, OK",18298,17052,1246,6,18501,17662,839,4,18596,17949,647,3,43609,43724,43668,125,523,531,144,749,756,3427,9835,10801,5148
40073,OK,"Kingfisher County, OK",8744,8353,391,4,8719,8480,239,2,8986,8808,178,2,15174,15253,15293,52,194,194,30,190,197,1049,4018,2464,2188
40075,OK,"Kiowa County, OK",3507,3326,181,5,3631,3502,129,3,3656,3538,118,3,8493,8358,8345,26,84,83,41,198,201,828,1961,2042,1102
40077,OK,"Latimer County, OK",3148,2822,326,10,3105,2873,232,7,3147,2971,176,5,9481,9482,9630,33,105,112,22,133,140,884,2445,2349,841
40079,OK,"Le Flore County, OK",19179,17811,1368,7,19399,18463,936,4,19606,18883,723,3,48195,48601,48907,140,564,573,148,784,821,5121,13027,9331,4968
40081,OK,"Lincoln County, OK",15499,14606,893,5,15860,15270,590,3,16235,15741,494,3,33495,33856,34188,93,354,357,98,467,480,2545,9674,7422,3468
40083,OK,"Logan County, OK",22286,21112,1174,5,22808,22029,779,3,23396,22764,632,2,49743,50924,51933,111,494,498,94,461,471,2722,10128,9843,9873
40085,OK,"Love County, OK",6510,6230,280,4,6060,5892,168,2,5870,5730,140,2,10159,10244,10218,30,128,130,36,153,153,1057,2601,2064,1006
40087,OK,"McClain County, OK",20054,18924,1130,5,20447,19781,666,3,20969,20412,557,2,41911,43497,45306,97,395,402,90,468,463,2950,8677,8785,7196
40089,OK,"McCurtain County, OK",14986,13961,1025,6,15848,15119,729,4,15961,15330,631,4,30838,30884,30931,120,455,463,108,567,573,3273,8860,5405,3001
40091,OK,"McIntosh County, OK",7126,6509,617,8,7177,6728,449,6,7271,6915,356,4,18950,19262,19451,41,200,204,88,391,407,1914,6111,4173,1776
40093,OK,"Major County, OK",3678,3498,180,4,3708,3589,119,3,3813,3723,90,2,7746,7617,7502,14,73,72,27,130,129,548,2162,1554,975
40095,OK,"Marshall County, OK",6820,6369,451,6,7070,6801,269,3,7384,7159,225,3,15340,15546,15882,45,182,184,45,261,264,1974,3903,2993,1670
40097,OK,"Mayes County, OK",19292,18284,1008,5,19488,18724,764,3,19755,19137,618,3,39053,39246,39589,102,433,442,139,590,590,3211,10885,8810,3975
40099,OK,"Murray County, OK",6128,5740,388,6,6124,5874,250,4,6123,5937,186,3,13877,13712,13672,34,142,144,47,232,241,1366,3955,2508,1690
40101,OK,"Muskogee County, OK",29079,27268,1811,6,29014,27699,1315,4,28816,27819,997,3,66241,66255,66354,220,846,856,248,1140,1136,6080,15431,13959,8869
40103,OK,"Noble County, OK",5465,5236,229,4,5580,5431,149,2,5819,5692,127,2,10922,10942,10896,38,122,123,34,169,169,777,2658,2413,1589
40105,OK,"Nowata County, OK",4599,4351,248,5,4655,4484,171,3,4727,4592,135,2,9322,9387,9483,28,117,123,26,138,148,717,2705,2110,1054
40107,OK,"Okfuskee County, OK",4400,4098,302,6,4427,4203,224,5,4434,4260,174,3,11271,11196,11134,29,116,119,35,230,235,1444,3151,2484,845
40109,OK,"Oklahoma County, OK",384398,359129,25269,6,390996,374440,16556,4,398536,386819,11717,2,798200,799622,802559,2656,10884,11045,1900,9484,9528,59864,127327,155471,174202
40111,OK,"Okmulgee County, OK",15366,14213,1153,7,15503,14667,836,5,15623,14969,654,4,36686,36827,36990,110,405,414,135,646,666,3299,8575,9002,3715
40113,OK,"Osage County, OK",20187,18834,1353,6,20316,19419,897,4,20575,19835,740,3,45778,45868,45839,98,328,332,121,545,549,3483,11954,10984,6197
40115,OK,"Ottawa County, OK",14264,13435,829,5,14501,14014,487,3,15150,14726,424,2,30229,30400,30338,80,365,368,107,511,529,2726,7003,7090,3073
40117,OK,"Pawnee County, OK",7244,6756,488,6,7302,6986,316,4,7387,7118,269,3,15552,15761,15757,44,192,191,51,264,275,1209,4553,3155,1872
40119,OK,"Payne County, OK",37640,35604,2036,5,38045,36749,1296,3,39102,38014,1088,2,81645,82149,82794,182,746,762,147,727,746,3521,12141,11796,17013
40121,OK,"Pittsburg County, OK",16659,15363,1296,7,16496,15595,901,5,16389,15686,703,4,43784,43695,43613,123,477,488,151,722,743,3984,11470,9512,5727
40123,OK,"Pontotoc County, OK",19161,18146,1015,5,19193,18520,673,3,19455,18917,538,2,38087,38195,38141,110,507,517,118,545,566,2616,7932,6913,7245
40125,OK,"Pottawatomie County, OK",32261,30240,2021,6,32741,31416,1325,4,33267,32124,1143,3,72542,73092,73533,212,866,886,212,1084,1087,5457,16689,16148,9809
40127,OK,"Pushmataha County, OK",4455,4151,304,6,4724,4514,210,4,4593,4417,176,3,10796,10789,10769,19,99,101,44,201,212,1124,3433,2032,1172
40129,OK,"Roger Mills County, OK",1778,1686,92,5,1807,1753,54,3,1804,1762,42,2,3428,3361,3320,9,33,33,14,59,61,207,829,866,475
40131,OK,"Rogers County, OK",44731,42068,2663,6,44969,43307,1662,3,45566,44242,1324,2,95387,96796,98836,257,971,983,242,1147,1178,5242,21200,21830,16125
40133,OK,"Seminole County, OK",9197,8496,701,7,9176,8693,483,5,9253,8868,385,4,23515,23498,23351,59,255,262,103,451,473,2518,5564,5431,2245
40135,OK,"Sequoyah County, OK",16511,15360,1151,7,16689,15936,753,4,16858,16278,580,3,39246,39442,39667,111,446,454,151,683,697,4699,10609,7773,3836
40137,OK,"Stephens County, OK",18486,17008,1478,8,18754,17879,875,4,19226,18609,617,3,42814,43174,43710,114,454,463,130,657,660,3603,12610,8112,5381
40139,OK,"Texas County, OK",11272,11004,268,2,11491,11268,223,1,11931,11717,214,1,21291,20822,20495,74,294,299,49,224,216,3506,3048,3128,3397
40141,OK,"Tillman County, OK",3025,2832,193,6,2950,2816,134,4,2943,2845,98,3,6948,7039,6977,19,78,78,31,129,131,1002,1606,1321,840
40143,OK,"Tulsa County, OK",323367,301625,21742,6,324695,311008,13687,4,326901,317012,9889,3,670653,673961,677358,2064,8666,8799,1596,7521,7607,44514,110919,138882,143193
40145,OK,"Wagoner County, OK",38468,36184,2284,5,38741,37298,1443,3,39229,38048,1181,3,81379,84198,86644,200,844,854,175,834,867,4947,17017,19072,13909
40147,OK,"Washington County, OK",22221,20884,1337,6,22532,21640,892,4,22396,21661,735,3,52604,52857,53242,147,597,608,159,765,784,3381,11805,9996,10443
40149,OK,"Washita County, OK",5098,4745,353,6,4997,4774,223,4,5291,5131,160,3,10903,10881,10732,35,140,139,36,183,177,778,3072,2173,1428
40151,OK,"Woods County, OK",4592,4430,162,3,4748,4644,104,2,4698,4610,88,1,8598,8613,8587,25,91,91,29,114,113,461,1664,1546,1751
40153,OK,"Woodward County, OK",8907,8288,619,6,8682,8304,378,4,8625,8371,254,2,20406,20216,19990,63,218,220,58,270,273,1686,5640,3876,2730
41000,OR,Oregon,2107362,1947567,159795,7,2147611,2035428,112183,5,2176734,2085939,90795,4,4244795,4256301,4240137,10280,39736,41143,9533,41956,46232,252602,668083,1009617,1041094
41001,OR,"Baker County, OR",7279,6755,524,7,7461,7074,387,5,7435,7082,353,4,16725,16873,16938,45,149,157,48,251,276,1130,3599,4564,2968
41003,OR,"Benton County, OR",46709,44091,2618,5,47620,45720,1900,4,49114,47366,1748,3,95208,96277,97630,154,616,625,141,680,732,2143,8353,16468,30853
41005,OR,"Clackamas County, OR",218684,202868,15816,7,222801,211961,10840,4,227202,218564,8638,3,422444,423763,423177,1015,3744,3844,937,3855,4277,16842,64399,100525,115606
41007,OR,"Clatsop County, OR",19289,17461,1828,9,19498,18341,1157,5,19645,18802,843,4,41160,41916,41695,98,341,350,95,467,517,2361,8241,11680,7729
41009,OR,"Columbia County, OR",24169,22257,1912,7,24631,23215,1416,5,25184,23973,1211,4,52730,53229,53588,143,482,490,115,575,626,3606,12418,14970,6786
41011,OR,"Coos County, OR",26612,24313,2299,8,26871,25184,1687,6,26597,25196,1401,5,64971,65119,64990,130,544,560,216,1033,1137,4854,14537,19301,9645
41013,OR,"Crook County, OR",10384,9466,918,8,10958,10225,733,6,11220,10607,613,5,24923,25753,26375,53,233,242,62,296,314,1655,5715,7022,3678
41015,OR,"Curry County, OR",8973,8193,780,8,9212,8602,610,6,9213,8715,498,5,23516,23720,23598,37,147,155,117,479,525,1533,5208,7647,4565
41017,OR,"Deschutes County, OR",98370,90552,7818,7,102304,96879,5425,5,103230,98937,4293,4,199454,205358,206549,462,1839,1900,376,1665,1857,8105,28930,50656,55259
41019,OR,"Douglas County, OR",47384,43710,3674,7,47967,45155,2812,5,47728,45215,2513,5,111288,112057,112297,236,1019,1052,419,1867,2044,7716,26143,32440,15307
41021,OR,"Gilliam County, OR",994,932,62,6,944,899,45,4,956,918,38,4,2017,2015,2018,7,20,21,5,26,30,97,478,575,328
41023,OR,"Grant County, OR",3205,2936,269,8,3244,3027,217,6,3213,3016,197,6,7241,7288,7218,19,68,68,24,109,117,526,1977,2087,969
41025,OR,"Harney County, OR",3641,3424,217,6,3782,3587,195,5,3807,3622,185,4,7502,7590,7515,23,77,78,26,106,122,503,1987,2076,831
41027,OR,"Hood River County, OR",14116,13231,885,6,14464,13808,656,4,14322,13810,512,3,23958,24094,24048,53,227,232,43,197,208,2747,3131,4221,6299
41029,OR,"Jackson County, OR",105244,97021,8223,7,107177,101312,5865,5,106841,101844,4997,4,223614,224327,221644,546,2135,2206,604,2745,3065,14539,40224,56668,47806
41031,OR,"Jefferson County, OR",10335,9483,852,8,10478,9803,675,6,10303,9735,568,5,24577,25122,25330,83,280,295,65,314,336,2031,4914,6278,3486
41033,OR,"Josephine County, OR",36155,33293,2862,7,36787,34503,2284,6,36805,34760,2045,5,88235,88590,87730,195,789,822,290,1432,1572,5990,19899,27495,11783
41035,OR,"Klamath County, OR",29562,26984,2578,8,29882,27876,2006,6,30314,28496,1818,6,69547,70255,70212,203,755,780,223,1006,1109,5618,15812,16664,10204
41037,OR,"Lake County, OR",3661,3454,207,5,3734,3528,206,5,3694,3493,201,5,8167,8285,8385,19,76,78,24,118,136,847,2056,2017,1154
41039,OR,"Lane County, OR",179364,165245,14119,7,182572,172491,10081,5,183397,175024,8373,4,383279,384063,382353,775,3028,3139,943,4292,4701,18736,59763,99373,85523
41041,OR,"Lincoln County, OR",20778,18526,2252,10,21148,19726,1422,6,21012,19922,1090,5,50507,51026,50813,84,371,382,176,680,752,2793,9263,15419,11003
41043,OR,"Linn County, OR",59208,54623,4585,7,60734,57327,3407,5,61677,58834,2843,4,128978,129948,130467,358,1414,1470,382,1627,1754,8686,25556,36702,17529
41045,OR,"Malheur County, OR",12594,11932,662,5,12744,12181,563,4,12682,12126,556,4,31650,31709,31879,105,380,390,86,383,411,3755,6423,7244,2864
41047,OR,"Marion County, OR",162817,151478,11339,7,167391,158816,8575,5,170317,163052,7265,4,346339,347775,346703,982,3811,3990,828,3252,3592,32694,58589,80981,55923
41049,OR,"Morrow County, OR",5760,5462,298,5,5951,5674,277,4,5997,5750,247,4,12220,12358,12300,45,167,170,18,108,122,1710,2521,2562,792
41051,OR,"Multnomah County, OR",456648,417349,39299,8,461480,436178,25302,5,469056,450658,18398,3,816467,805593,795083,1956,7384,7688,1473,6508,7197,45545,101565,167740,281836
41053,OR,"Polk County, OR",40709,38055,2654,6,41967,39916,2051,4,42727,40924,1803,4,87950,89384,89614,221,858,877,188,809,887,4729,12871,21251,17269
41055,OR,"Sherman County, OR",979,918,61,6,965,923,42,4,961,929,32,3,1873,1912,1955,9,24,24,4,23,25,163,397,494,231
41057,OR,"Tillamook County, OR",11876,10923,953,8,12164,11496,668,5,12164,11625,539,4,27466,27800,27574,62,234,242,94,361,402,1902,5995,7925,4559
41059,OR,"Umatilla County, OR",36906,34391,2515,6,37606,35621,1985,5,38062,36310,1752,4,80098,80154,80215,239,909,948,173,844,925,8780,15548,18539,9513
41061,OR,"Union County, OR",12031,11085,946,7,12214,11529,685,5,12209,11630,579,4,26167,26276,26177,70,249,256,78,308,337,1269,5787,6207,4232
41063,OR,"Wallowa County, OR",3467,3220,247,7,3609,3411,198,5,3615,3419,196,5,7401,7554,7659,17,60,58,12,90,100,334,1574,2131,1538
41065,OR,"Wasco County, OR",13468,12513,955,7,13643,12929,714,5,13505,12923,582,4,26631,26735,26561,73,257,263,84,351,388,2421,5035,7291,3912
41067,OR,"Washington County, OR",321086,300213,20873,6,327552,313117,14435,4,335323,323660,11663,3,601101,602494,600176,1507,6016,6233,911,3950,4389,28950,71481,124532,188259
41069,OR,"Wheeler County, OR",696,665,31,4,724,700,24,3,740,715,25,3,1460,1453,1445,2,9,10,4,19,21,118,362,432,223
41071,OR,"Yamhill County, OR",54212,50548,3664,6,55337,52696,2641,4,56468,54288,2180,3,107931,108436,108226,254,1024,1048,249,1130,1229,7174,17332,27440,20632
42000,PA,Pennsylvania,6514565,5933182,581383,8,6445362,6058976,386386,6,6479077,6196385,282692,4,12994440,13012059,12972008,32901,129979,132099,40229,155784,155120,787376,3079339,2227532,3017250
42001,PA,"Adams County, PA",54895,51175,3720,6,54751,52434,2317,4,54793,52971,1822,3,103779,105632,106027,203,909,914,317,1216,1209,7495,29157,18988,17567
42003,PA,"Allegheny County, PA",647360,589879,57481,8,634367,597797,36570,5,631720,605146,26574,4,1249524,1245445,1233253,3105,12168,12319,3599,15304,15195,44384,234448,233359,390990
42005,PA,"Armstrong County, PA",31865,28795,3070,9,31432,29175,2257,7,31170,29531,1639,5,65459,65138,64747,141,552,591,212,1010,1017,3708,23866,12130,9039
42007,PA,"Beaver County, PA",84078,75564,8514,10,82117,76567,5550,6,81913,77524,4389,5,167860,166914,165677,368,1507,1518,590,2447,2432,6722,45305,39339,31940
42009,PA,"Bedford County, PA",24062,21937,2125,8,23907,22556,1351,5,24388,23292,1096,4,47569,47495,47418,118,466,473,144,737,729,3675,17339,8367,5503
42011,PA,"Berks County, PA",216006,195897,20109,9,212766,199614,13152,6,213839,204613,9226,4,428631,429612,430449,1097,4426,4494,1322,4717,4686,36218,106288,73049,75301
42013,PA,"Blair County, PA",60336,55190,5146,8,59495,56103,3392,5,59014,56375,2639,4,122651,122181,121032,287,1144,1169,385,1901,1892,6737,39331,21819,20520
42015,PA,"Bradford County, PA",28615,26507,2108,7,28112,26613,1499,5,28086,26897,1189,4,59969,60099,59866,155,630,639,148,805,802,4163,20203,9888,8309
42017,PA,"Bucks County, PA",345202,317151,28051,8,345392,328006,17386,5,350904,337536,13368,3,646112,647159,645054,1421,5406,5493,2099,7075,6991,25470,128121,110086,198250
42019,PA,"Butler County, PA",99879,92254,7625,7,98771,93483,5288,5,98743,94625,4118,4,194056,196789,197300,458,1661,1698,504,2392,2390,6194,43065,35868,52636
42021,PA,"Cambria County, PA",57252,51908,5344,9,55886,52151,3735,6,55389,52414,2975,5,133199,132281,131441,310,1154,1177,415,2141,2111,7224,42381,24954,21464
42023,PA,"Cameron County, PA",2073,1819,254,12,2012,1865,147,7,1946,1835,111,5,4531,4461,4418,12,27,28,13,76,71,269,1846,1059,377
42025,PA,"Carbon County, PA",32118,29037,3081,9,32186,30134,2052,6,32539,30884,1655,5,64744,65460,65460,138,591,601,226,997,982,4641,21490,13275,8460
42027,PA,"Centre County, PA",78001,73549,4452,5,76636,73253,3383,4,78053,75238,2815,3,157962,157990,158425,266,1079,1108,286,1217,1221,5525,27689,19850,44952
42029,PA,"Chester County, PA",286697,268662,18035,6,288974,277371,11603,4,295146,285697,9449,3,534783,540864,545823,1379,5392,5468,1309,4568,4526,19947,72108,70558,200722
42031,PA,"Clarion County, PA",17076,15690,1386,8,16695,15662,1033,6,16107,15272,835,5,37193,37581,37346,81,355,361,111,573,574,2452,12183,5334,5650
42033,PA,"Clearfield County, PA",36259,32991,3268,9,35741,33360,2381,6,35210,33324,1886,5,80438,78333,77904,152,673,683,241,1142,1152,6847,28481,13746,11043
42035,PA,"Clinton County, PA",17994,16459,1535,8,17328,16227,1101,6,17010,16101,909,5,37380,38035,37931,110,397,407,111,469,461,2467,11797,5755,4802
42037,PA,"Columbia County, PA",33949,31250,2699,8,33674,31803,1871,5,33958,32434,1524,4,64682,64980,64926,131,537,539,204,838,835,3890,19234,9750,10835
42039,PA,"Crawford County, PA",38846,35461,3385,8,38086,35684,2402,6,37940,36124,1816,4,83797,83202,82670,197,846,858,211,1177,1201,5757,27920,13497,11954
42041,PA,"Cumberland County, PA",133770,125046,8724,6,132981,127115,5866,4,135057,130440,4617,3,260223,265593,268579,704,2611,2652,619,2775,2772,12169,57062,42277,68927
42043,PA,"Dauphin County, PA",147271,134404,12867,8,145287,136639,8648,6,146107,140276,5831,4,286685,288187,288800,889,3299,3349,786,3094,3108,17911,64805,50814,63583
42045,PA,"Delaware County, PA",300427,273338,27089,9,298233,280675,17558,5,301586,289105,12481,4,576323,576772,575182,1633,6280,6382,2089,6199,6189,25666,109181,97672,158583
42047,PA,"Elk County, PA",15484,13636,1848,11,14964,13994,970,6,14659,13942,717,4,30926,30771,30477,61,253,255,84,432,437,1597,11270,5594,4277
42049,PA,"Erie County, PA",129331,116878,12453,9,127008,118260,8748,6,125979,119735,6244,5,270539,269300,267689,635,2654,2709,745,3379,3368,15628,69820,47938,53981
42051,PA,"Fayette County, PA",57066,50467,6599,11,55721,51139,4582,8,55125,51763,3362,6,128569,127113,125755,299,1210,1235,411,2210,2198,10430,45513,22130,17018
42053,PA,"Forest County, PA",1823,1634,189,10,1753,1615,138,7,1693,1583,110,6,6959,6896,6626,8,27,25,25,106,107,1012,3257,1146,685
42055,PA,"Franklin County, PA",78906,73032,5874,7,77772,73964,3808,4,78065,75180,2885,3,155939,156589,156902,400,1644,1683,456,1995,1999,11678,46862,25449,25047
42057,PA,"Fulton County, PA",7535,6653,882,11,7147,6721,426,6,7209,6911,298,4,14572,14509,14533,37,138,139,33,226,215,1205,5196,2523,1668
42059,PA,"Greene County, PA",16227,14677,1550,9,15804,14715,1089,6,15490,14664,826,5,35859,35269,34663,80,321,325,101,524,527,3089,11590,6520,4656
42061,PA,"Huntingdon County, PA",19910,17855,2055,10,19323,17984,1339,6,19287,18201,1086,5,44047,43937,43281,96,391,405,112,586,587,3236,16083,7208,5610
42063,PA,"Indiana County, PA",38312,34894,3418,8,37315,34798,2517,6,36387,34443,1944,5,83142,83158,82957,195,770,780,245,1141,1120,4549,22760,13558,14139
42065,PA,"Jefferson County, PA",20448,18689,1759,8,19755,18527,1228,6,19465,18518,947,4,44478,44142,43794,111,462,471,116,653,658,3020,16212,7265,5189
42067,PA,"Juniata County, PA",12809,11910,899,7,12598,11994,604,4,12436,11902,534,4,23471,23348,23339,79,300,306,71,337,342,2804,8115,3198,2396
42069,PA,"Lackawanna County, PA",105507,95532,9975,9,103916,97207,6709,6,105154,100191,4963,4,215523,215957,215615,567,2055,2089,891,2964,2941,12847,55017,39547,44781
42071,PA,"Lancaster County, PA",286983,265888,21095,7,287023,273538,13485,4,290028,279806,10222,3,552761,556049,556629,1628,6879,7006,1679,5964,5961,50736,127880,82668,110550
42073,PA,"Lawrence County, PA",40962,36800,4162,10,39804,36946,2858,7,39356,37233,2123,5,85959,85554,84849,228,798,809,327,1407,1427,5110,27035,16552,13322
42075,PA,"Lebanon County, PA",73360,67655,5705,7,73148,69346,3802,5,73390,70653,2737,3,143282,143809,144011,382,1551,1576,453,1862,1852,12150,41794,22200,21545
42077,PA,"Lehigh County, PA",195716,177313,18403,9,196664,184063,12601,6,197173,188561,8612,4,374477,375760,376317,1013,3991,4041,1195,3994,3957,26144,81618,66073,79797
42079,PA,"Luzerne County, PA",160151,142941,17210,10,157636,145451,12185,7,158322,149895,8427,5,325197,325889,326369,766,3150,3199,1253,4723,4664,22658,88518,64856,55652
42081,PA,"Lycoming County, PA",57031,52099,4932,8,55641,52102,3539,6,55176,52561,2615,4,114108,113595,113104,285,1138,1155,338,1546,1534,7552,30958,22393,19572
42083,PA,"McKean County, PA",17400,15726,1674,9,17085,15966,1119,6,16905,15998,907,5,40392,40292,39866,107,345,353,120,591,592,2124,13613,7513,5642
42085,PA,"Mercer County, PA",48918,44264,4654,9,48229,44991,3238,6,47778,45389,2389,5,110534,109950,109220,272,1016,1028,340,1785,1774,7798,32995,19923,18275
42087,PA,"Mifflin County, PA",21435,19657,1778,8,21077,19861,1216,5,21017,20015,1002,4,46144,46187,45988,152,541,551,147,722,693,4750,16075,7238,4306
42089,PA,"Monroe County, PA",83158,73777,9381,11,82205,76280,5925,7,82484,77767,4717,5,168316,168629,167198,370,1372,1390,477,1818,1800,12176,40417,34395,30662
42091,PA,"Montgomery County, PA",457250,423171,34079,7,459375,437689,21686,4,466848,450573,16275,3,856938,864022,864683,2161,8416,8546,2753,8728,8642,32006,136362,126668,303992
42093,PA,"Montour County, PA",9146,8589,557,6,9118,8739,379,4,9234,8917,317,3,18129,18103,18091,53,205,206,49,255,252,1105,4744,2679,4706
42095,PA,"Northampton County, PA",162165,147927,14238,8,162767,153557,9210,5,164277,157321,6956,4,312774,318051,318526,696,2756,2820,1057,3552,3537,18288,73343,55354,71686
42097,PA,"Northumberland County, PA",42997,39037,3960,9,42465,39748,2717,6,42274,40181,2093,5,91542,91013,90133,211,875,896,301,1407,1403,6962,33069,15110,11941
42099,PA,"Perry County, PA",24458,22834,1624,6,24284,23194,1090,4,24696,23798,898,3,45828,45941,46114,126,468,473,120,562,568,3660,15289,8027,5886
42101,PA,"Philadelphia County/city, PA",739327,648806,90521,12,724116,662481,61635,8,731792,692255,39537,5,1600600,1589480,1567258,4896,19355,19659,5473,17012,17026,147268,343452,248140,356096
42103,PA,"Pike County, PA",25565,22926,2639,10,25388,23643,1745,6,25792,24337,1455,5,58560,59965,60558,93,396,411,187,635,639,3018,14903,14044,11693
42105,PA,"Potter County, PA",7321,6652,669,9,7116,6650,466,6,6900,6495,405,5,16385,16287,16220,44,167,173,58,263,272,1261,5552,3202,1950
42107,PA,"Schuylkill County, PA",67295,61177,6118,9,65787,61582,4205,6,65931,62665,3266,5,142946,143201,143104,325,1229,1248,503,2239,2218,11083,47377,27535,18593
42109,PA,"Snyder County, PA",19744,18265,1479,7,19737,18760,977,5,19713,18869,844,4,39727,39742,39652,98,397,409,94,417,429,3596,11630,5638,5761
42111,PA,"Somerset County, PA",33302,30220,3082,9,32839,30738,2101,6,32520,30758,1762,5,74016,72999,72710,158,605,611,244,1162,1148,5855,27226,13142,9391
42113,PA,"Sullivan County, PA",2627,2407,220,8,2574,2394,180,7,2551,2417,134,5,5823,5859,5855,8,46,45,25,118,121,471,2384,1160,877
42115,PA,"Susquehanna County, PA",20129,18683,1446,7,20147,19097,1050,5,20225,19369,856,4,38334,38363,38074,86,346,351,156,570,566,2738,13365,7161,5615
42117,PA,"Tioga County, PA",19198,17498,1700,8,19028,17832,1196,6,19009,18072,937,4,41014,41335,41106,105,394,402,107,534,576,2650,12950,7749,6085
42119,PA,"Union County, PA",19654,18356,1298,6,19640,18759,881,4,19560,18803,757,3,42639,42419,42744,103,379,386,114,496,485,3460,12399,5840,7674
42121,PA,"Venango County, PA",22517,20548,1969,8,22039,20613,1426,6,21409,20334,1075,5,50354,50038,49777,102,447,457,144,818,831,3158,17667,9474,7303
42123,PA,"Warren County, PA",18955,17449,1506,7,18149,16991,1158,6,17650,16825,825,4,38516,38115,37808,65,344,351,126,633,646,1965,13193,7834,5566
42125,PA,"Washington County, PA",107314,97436,9878,9,105345,98741,6604,6,104741,99939,4802,4,209382,210012,210383,490,1873,1927,630,2932,2903,9231,54941,38558,47727
42127,PA,"Wayne County, PA",22496,20476,2020,9,22588,21175,1413,6,22737,21586,1151,5,51151,51195,51173,105,414,419,165,772,768,3726,17422,10479,7706
42129,PA,"Westmoreland County, PA",179630,163589,16041,8,176380,165810,10570,6,175757,167758,7999,4,354316,353765,352057,700,2819,2835,1137,5250,5213,13441,94051,74816,81002
42131,PA,"Wyoming County, PA",13404,12297,1107,8,13306,12507,799,6,13535,12876,659,4,26030,26100,26014,61,226,227,81,381,386,1343,8805,4885,3975
42133,PA,"York County, PA",237579,218905,18674,7,236762,224527,12235,5,238732,229672,9060,3,456692,459148,461058,1089,4706,4796,1145,5213,5192,29267,123317,82716,81848
44000,RI,Rhode Island,570185,517949,52236,9,571698,540182,31516,5,569455,551220,18235,3,1096345,1096985,1093734,2546,10013,10544,3388,11348,11110,83508,213716,198622,270769
44001,RI,"Bristol County, RI",26196,24253,1943,7,26539,25294,1245,4,26500,25810,690,2,50774,50800,50360,95,327,345,140,564,565,3000,7413,7628,17656
44003,RI,"Kent County, RI",93322,85358,7964,8,93825,89024,4801,5,93535,90836,2699,2,170386,170997,171275,365,1452,1508,550,2109,2016,9465,35915,38921,41293
44005,RI,"Newport County, RI",44717,41154,3563,8,45113,42921,2192,4,45058,43795,1263,2,85508,85662,84481,163,591,643,190,749,789,3547,12700,15017,32111
44007,RI,"Providence County, RI",336486,303009,33477,9,335917,316021,19896,5,334104,322458,11646,3,659920,658646,657288,1738,6827,7177,2145,6552,6399,62521,138042,113141,138208
44009,RI,"Washington County, RI",69465,64176,5289,7,70303,66921,3382,4,70259,68321,1938,2,129757,130880,130330,185,816,871,363,1374,1341,4975,19646,23915,41501
45000,SC,South Carolina,2335026,2195171,139855,6,2353968,2261060,92908,3,2374975,2297927,77048,3,5131848,5193266,5282634,13492,55591,57071,14077,65128,64531,393448,1008011,1059288,1046424
45001,SC,"Abbeville County, SC",9753,9123,630,6,9576,9144,432,4,9433,9068,365,3,24256,24258,24356,63,225,229,74,414,407,2790,6331,4882,3121
45003,SC,"Aiken County, SC",73774,70180,3594,4,73577,71099,2478,3,73032,70726,2306,3,169163,171263,174150,427,1887,1943,517,2179,2145,12692,37476,34225,34139
45005,SC,"Allendale County, SC",2551,2314,237,9,2417,2234,183,7,2261,2133,128,5,7992,7870,7579,18,67,68,32,139,144,1400,2328,1544,609
45007,SC,"Anderson County, SC",88599,83485,5114,5,89853,86551,3302,3,91417,88676,2741,3,204176,206852,209581,499,2188,2252,630,3083,3062,19741,42521,42612,34413
45009,SC,"Bamberg County, SC",4751,4335,416,8,4614,4279,335,7,4523,4275,248,5,13261,13112,12908,29,130,135,46,270,259,2017,2578,2827,1571
45011,SC,"Barnwell County, SC",7764,7206,558,7,7499,7025,474,6,7483,7134,349,4,20580,20580,20414,74,259,264,71,339,336,2584,5084,4312,1944
45013,SC,"Beaufort County, SC",74825,70867,3958,5,75796,73183,2613,3,76398,73997,2401,3,187819,192007,196371,471,1843,1883,467,2047,2026,8925,29787,39217,57252
45015,SC,"Berkeley County, SC",104256,98641,5615,5,106604,102766,3838,3,109632,106270,3362,3,231538,236871,245117,675,2780,2853,428,2123,2114,15692,44274,49354,41090
45017,SC,"Calhoun County, SC",6351,5971,380,6,6394,6109,285,4,6397,6173,224,3,14113,14134,14179,20,116,116,60,241,245,1452,3723,3350,1885
45019,SC,"Charleston County, SC",206699,193983,12716,6,209826,202346,7480,3,215121,209190,5931,2,409716,414403,419279,1186,4889,5026,904,4011,3962,20645,60891,73011,135620
45021,SC,"Cherokee County, SC",24780,22847,1933,7,24690,23468,1222,4,24159,23168,991,4,56207,56025,56121,142,638,660,181,914,908,6349,14271,11922,5558
45023,SC,"Chester County, SC",13178,12018,1160,8,13245,12490,755,5,13283,12717,566,4,32278,32097,31931,76,326,333,142,576,567,3471,9342,6794,2921
45025,SC,"Chesterfield County, SC",21335,20078,1257,5,21412,20463,949,4,21140,20385,755,3,43250,43337,43683,107,473,491,160,670,665,6092,11994,8608,3837
45027,SC,"Clarendon County, SC",12460,11641,819,6,12392,11797,595,4,11942,11454,488,4,30835,30950,30913,80,298,298,164,587,588,4612,8237,6395,3557
45029,SC,"Colleton County, SC",16261,15299,962,5,16097,15401,696,4,15773,15221,552,3,38536,38427,38599,118,445,455,177,728,707,3781,11449,7337,4376
45031,SC,"Darlington County, SC",29873,27993,1880,6,29726,28403,1323,4,29728,28674,1054,3,62843,62708,62398,172,734,746,253,1115,1121,6664,16041,13005,8156
45033,SC,"Dillon County, SC",12952,12178,774,6,13035,12293,742,5,12773,12187,586,4,28275,27981,27738,80,378,387,114,516,524,4024,8041,4560,2301
45035,SC,"Dorchester County, SC",75938,71646,4292,5,77428,74645,2783,3,79480,77174,2306,2,162159,163508,166133,454,1892,1937,325,1621,1601,10360,28283,37784,31933
45037,SC,"Edgefield County, SC",10370,9850,520,5,10324,9975,349,3,10237,9902,335,3,25672,26285,26932,36,167,171,69,325,320,3392,6507,5343,3669
45039,SC,"Fairfield County, SC",9198,8477,721,7,9196,8673,523,5,9204,8771,433,4,20880,20698,20455,50,191,196,93,390,395,2389,6544,4085,2423
45041,SC,"Florence County, SC",65524,61967,3557,5,65678,63043,2635,4,65938,63798,2140,3,136811,136439,136721,383,1579,1620,471,2099,2127,12731,30457,27158,22558
45043,SC,"Georgetown County, SC",25554,23685,1869,7,25745,24532,1213,4,25971,25001,970,3,63506,63991,64722,130,480,489,220,1065,1072,4860,13016,14846,14485
45045,SC,"Greenville County, SC",251538,237686,13852,5,255064,246447,8617,3,259853,252567,7286,2,527207,534521,547950,1545,6317,6498,1235,5821,5731,36661,82361,101000,134247
45047,SC,"Greenwood County, SC",30746,28836,1910,6,30179,28831,1348,4,29633,28542,1091,3,69388,69148,69267,191,761,775,221,1044,1041,6582,14891,14129,11341
45049,SC,"Hampton County, SC",7989,7607,382,4,7974,7692,282,3,7842,7615,227,2,18519,18236,18113,43,200,202,65,302,301,2481,5903,3529,1479
45051,SC,"Horry County, SC",144541,132397,12144,8,147228,139869,7359,5,150593,144734,5859,3,353745,366011,383101,793,3119,3204,1056,5232,5098,23048,85006,87328,63411
45053,SC,"Jasper County, SC",12802,12168,634,5,13063,12619,444,3,13170,12768,402,3,29143,30456,32039,98,373,392,69,348,346,2284,7423,5866,4779
45055,SC,"Kershaw County, SC",28881,27390,1491,5,29098,28026,1072,3,29308,28349,959,3,65581,66121,67751,164,698,726,205,1008,976,4643,16185,14941,9617
45057,SC,"Lancaster County, SC",42247,39455,2792,6,42882,41051,1831,4,43389,41829,1560,3,96576,100522,104577,259,1054,1092,262,1174,1159,8227,19059,20283,20389
45059,SC,"Laurens County, SC",29339,27378,1961,6,29640,28382,1258,4,30069,29056,1013,3,67624,67817,67965,160,715,733,227,1120,1126,8296,16546,13551,7991
45061,SC,"Lee County, SC",6664,6168,496,7,6554,6198,356,5,6380,6083,297,4,16533,16266,16153,37,154,155,99,301,303,2115,4680,3230,1893
45063,SC,"Lexington County, SC",147870,141631,6239,4,149564,145042,4522,3,150901,146865,4036,2,295033,300482,304797,759,3215,3320,740,3378,3299,19420,54996,63980,63734
45065,SC,"McCormick County, SC",3279,3066,213,6,3331,3174,157,4,3450,3327,123,3,9505,9782,9764,9,56,56,36,162,165,1312,2799,2190,1649
45067,SC,"Marion County, SC",12959,11974,985,7,12848,12027,821,6,12602,11988,614,4,29083,28839,28450,79,336,339,126,555,549,4011,9736,4188,2524
45069,SC,"Marlboro County, SC",9067,8208,859,9,8773,8122,651,7,8237,7704,533,6,26481,26265,26039,62,265,273,90,417,420,3899,9239,4574,1540
45071,SC,"Newberry County, SC",18832,17960,872,4,19161,18534,627,3,19056,18528,528,2,37731,37957,38247,93,394,406,121,612,603,3601,8883,8097,5461
45073,SC,"Oconee County, SC",34254,32479,1775,5,33956,32729,1227,3,34008,32959,1049,3,78778,79322,80180,167,632,644,208,1151,1168,7907,16206,16971,15868
45075,SC,"Orangeburg County, SC",34021,31024,2997,8,33420,31124,2296,6,32653,31008,1645,5,83956,82798,83094,198,824,840,330,1434,1436,9042,18258,19374,10977
45077,SC,"Pickens County, SC",55676,52798,2878,5,56738,54779,1959,3,57944,56147,1797,3,131669,132079,133462,304,1142,1174,328,1758,1715,11032,24328,24617,22346
45079,SC,"Richland County, SC",194541,183448,11093,5,195793,187847,7946,4,196833,190394,6439,3,415645,417132,421566,1127,4552,4673,940,4054,4046,21457,56760,79980,103938
45081,SC,"Saluda County, SC",8335,7987,348,4,8390,8126,264,3,8383,8143,240,2,18830,18821,18938,50,226,231,69,309,312,2509,4687,3620,2586
45083,SC,"Spartanburg County, SC",155960,146077,9883,6,154865,148786,6079,3,154045,149194,4851,3,329365,335406,345831,886,3783,3876,875,4282,4259,27324,67289,69545,54415
45085,SC,"Sumter County, SC",42946,40147,2799,6,42541,40615,1926,4,41872,40268,1604,3,105474,104856,104012,348,1356,1390,339,1525,1538,8296,22075,23614,15564
45087,SC,"Union County, SC",11452,10431,1021,8,11341,10630,711,6,11188,10661,527,4,27176,26994,26752,72,264,267,118,506,509,3342,7411,6041,2639
45089,SC,"Williamsburg County, SC",11483,10560,923,8,11081,10420,661,6,10762,10249,513,4,30908,30384,30058,64,256,261,127,574,561,3596,9556,5732,3498
45091,SC,"York County, SC",142861,134514,8347,5,145367,140074,5293,3,147487,142858,4629,3,284032,289255,294248,694,2914,2992,593,2609,2575,15700,44559,59737,67120
46000,SD,South Dakota,464505,444899,19606,4,469583,457174,12409,2,475065,465250,9815,2,887799,896164,909824,2832,11067,11392,2023,9867,9231,43328,174791,188079,174037
46003,SD,"Aurora County, SD",1473,1430,43,2,1486,1456,30,2,1491,1463,28,1,2733,2732,2755,6,39,39,10,46,42,171,646,585,314
46005,SD,"Beadle County, SD",9366,9040,326,3,9289,9063,226,2,9285,9105,180,1,19165,19182,19376,75,269,278,46,207,193,1770,4198,3502,2971
46007,SD,"Bennett County, SD",1077,1027,50,4,1055,1017,38,3,1071,1036,35,3,3389,3400,3336,14,45,46,8,45,49,206,537,656,354
46009,SD,"Bon Homme County, SD",2855,2750,105,3,2828,2759,69,2,2842,2788,54,1,6973,7011,7062,13,73,75,20,120,108,581,1707,1656,1164
46011,SD,"Brookings County, SD",18520,17783,737,4,18601,18091,510,2,19113,18717,396,2,34350,34710,35484,90,365,370,56,234,218,692,4524,5292,7918
46013,SD,"Brown County, SD",20588,19766,822,4,20561,20032,529,2,20078,19626,452,2,38222,38090,37972,99,403,413,98,445,402,1717,7762,7612,8192
46015,SD,"Brule County, SD",2472,2372,100,4,2568,2513,55,2,2657,2612,45,1,5253,5254,5321,10,65,67,16,47,48,416,1213,993,854
46017,SD,"Buffalo County, SD",691,640,51,7,699,667,32,4,731,698,33,4,1938,1912,1861,7,39,37,9,43,42,188,411,331,69
46019,SD,"Butte County, SD",4991,4746,245,4,5022,4877,145,2,5029,4931,98,1,10286,10530,10774,44,132,132,24,129,131,608,2833,2134,1422
46021,SD,"Campbell County, SD",784,759,25,3,773,752,21,2,772,752,20,2,1377,1375,1349,5,12,13,2,23,24,135,329,310,289
46023,SD,"Charles Mix County, SD",3776,3558,218,5,3808,3688,120,3,3815,3728,87,2,9356,9186,9213,29,141,142,31,121,120,673,2003,1764,1278
46025,SD,"Clark County, SD",2156,2078,78,3,1934,1872,62,3,1953,1908,45,2,3855,3867,3912,17,58,58,14,42,44,152,1110,737,474
46027,SD,"Clay County, SD",7157,6861,296,4,7337,7150,187,2,7377,7219,158,2,14996,15155,15280,25,121,126,20,108,108,375,1887,1703,3365
46029,SD,"Codington County, SD",15466,14776,690,4,15716,15302,414,2,15970,15650,320,2,28350,28467,28721,79,299,310,63,345,304,1620,7450,6270,3896
46031,SD,"Corson County, SD",1323,1264,59,4,1309,1257,52,4,1282,1244,38,3,3891,3843,3826,17,82,82,11,71,58,302,776,743,334
46033,SD,"Custer County, SD",4048,3824,224,5,4135,3993,142,3,4228,4108,120,2,8334,8635,9006,19,73,71,31,107,101,469,2399,2003,1776
46035,SD,"Davison County, SD",10943,10528,415,3,10956,10696,260,2,11074,10866,208,1,19962,19926,19973,63,245,252,37,252,234,1358,4528,4478,3057
46037,SD,"Day County, SD",2695,2556,139,5,2679,2582,97,3,2685,2604,81,3,5442,5435,5479,16,43,43,13,91,82,314,1487,1278,828
46039,SD,"Deuel County, SD",2327,2215,112,4,2294,2211,83,3,2300,2233,67,2,4294,4280,4352,9,53,55,8,49,46,250,1072,956,690
46041,SD,"Dewey County, SD",2306,2149,157,6,2270,2158,112,4,2289,2158,131,5,5224,5218,5140,29,110,112,19,95,96,481,1059,863,495
46043,SD,"Douglas County, SD",1552,1511,41,2,1536,1504,32,2,1516,1486,30,2,2829,2809,2776,13,43,43,8,51,49,189,611,727,376
46045,SD,"Edmunds County, SD",1990,1938,52,2,2015,1970,45,2,1995,1957,38,1,3982,4028,4065,21,58,60,7,61,54,205,924,959,683
46047,SD,"Fall River County, SD",3013,2850,163,5,3081,2975,106,3,3069,2997,72,2,6972,7189,7370,10,43,44,28,145,142,352,1936,1882,1184
46049,SD,"Faulk County, SD",1037,1004,33,3,1056,1032,24,2,1085,1063,22,2,2128,2126,2126,12,34,34,7,39,36,124,443,533,373
46051,SD,"Grant County, SD",4371,4213,158,3,4354,4227,127,2,4388,4276,112,2,7532,7532,7463,16,82,85,16,115,106,420,1974,1549,1290
46053,SD,"Gregory County, SD",2043,1973,70,3,2079,2030,49,2,2137,2097,40,1,3997,3952,3962,10,44,44,14,81,79,267,1069,911,529
46055,SD,"Haakon County, SD",1058,1034,24,2,1045,1020,25,2,1079,1059,20,1,1870,1834,1826,1,15,17,5,26,25,55,601,430,207
46057,SD,"Hamlin County, SD",3365,3260,105,3,3478,3400,78,2,3586,3516,70,2,6157,6263,6352,37,137,140,23,86,76,284,1425,1147,767
46059,SD,"Hand County, SD",1751,1709,42,2,1752,1716,36,2,1784,1753,31,1,3145,3095,3140,14,43,43,5,57,54,154,636,827,539
46061,SD,"Hanson County, SD",1758,1677,81,4,1764,1704,60,3,1788,1741,47,2,3465,3496,3461,8,37,40,5,32,27,103,774,867,389
46063,SD,"Harding County, SD",720,697,23,3,714,697,17,2,749,734,15,2,1307,1320,1330,3,16,16,4,12,12,44,292,311,194
46065,SD,"Hughes County, SD",9883,9583,300,3,9924,9717,207,2,9907,9740,167,1,17745,17768,17692,63,215,223,51,205,201,457,3618,3980,4251
46067,SD,"Hutchinson County, SD",3611,3488,123,3,3611,3515,96,2,3621,3539,82,2,7421,7400,7368,19,87,88,16,115,111,475,1520,1712,1258
46069,SD,"Hyde County, SD",669,650,19,2,655,640,15,2,658,644,14,2,1249,1215,1184,3,14,15,10,31,28,87,331,422,169
46071,SD,"Jackson County, SD",1208,1162,46,3,1218,1172,46,3,1222,1185,37,3,2801,2846,2821,17,78,79,10,62,55,238,668,579,246
46073,SD,"Jerauld County, SD",1199,1172,27,2,1338,1315,23,1,1336,1318,18,1,1648,1640,1650,1,13,18,10,22,22,108,603,379,263
46075,SD,"Jones County, SD",523,505,18,3,521,507,14,2,523,510,13,2,925,884,884,2,10,10,1,9,10,38,228,144,258
46077,SD,"Kingsbury County, SD",2676,2587,89,3,2728,2661,67,2,2805,2752,53,1,5203,5201,5294,15,68,69,15,68,65,281,1366,1038,849
46079,SD,"Lake County, SD",6466,6243,223,3,6563,6393,170,2,6713,6575,138,2,11008,10863,10972,37,122,124,22,109,109,680,2139,2400,2574
46081,SD,"Lawrence County, SD",13572,12799,773,5,13839,13479,360,2,14136,13866,270,1,25838,26138,27214,57,198,202,57,309,295,1011,5067,5692,6207
46083,SD,"Lincoln County, SD",36269,35075,1194,3,36938,36163,775,2,37557,36938,619,1,65650,67995,70987,207,762,786,65,363,332,1708,9592,12939,17019
46085,SD,"Lyman County, SD",1668,1580,88,5,1680,1616,64,3,1687,1644,43,2,3709,3753,3692,6,62,65,10,42,45,204,778,722,592
46087,SD,"McCook County, SD",2998,2896,102,3,3059,2987,72,2,3116,3063,53,1,5673,5723,5778,27,84,83,21,82,78,324,1327,1101,954
46089,SD,"McPherson County, SD",996,949,47,4,967,933,34,3,977,951,26,2,2402,2414,2395,5,23,23,7,40,39,231,657,417,360
46091,SD,"Marshall County, SD",2421,2317,104,4,2423,2350,73,3,2485,2416,69,2,4315,4319,4374,17,62,62,9,52,48,264,937,984,852
46093,SD,"Meade County, SD",13875,13246,629,4,14224,13855,369,2,14501,14200,301,2,29900,30270,30698,62,246,257,44,241,240,889,5978,7360,5500
46095,SD,"Mellette County, SD",712,671,41,5,726,698,28,3,750,727,23,3,1921,1908,1892,8,28,28,10,25,23,225,435,356,174
46097,SD,"Miner County, SD",1149,1099,50,4,1169,1138,31,2,1227,1204,23,1,2310,2329,2304,10,27,28,2,35,38,178,703,471,282
46099,SD,"Minnehaha County, SD",113426,108738,4688,4,114910,112108,2802,2,116647,114479,2168,1,197686,199925,203971,729,2780,2882,445,1880,1732,8766,33038,43402,42854
46101,SD,"Moody County, SD",4024,3834,190,4,4012,3917,95,2,4015,3926,89,2,6343,6314,6349,25,81,82,9,82,70,252,1351,1495,1128
46102,SD,"Oglala Lakota County, SD",3779,3444,335,8,3861,3576,285,7,3778,3592,186,4,13645,13549,13519,60,246,255,44,209,188,1922,2152,2364,744
46103,SD,"Pennington County, SD",57414,54643,2771,4,58741,57140,1601,2,59759,58547,1212,2,109563,111854,114461,354,1421,1478,262,1280,1187,4142,21038,24619,24805
46105,SD,"Perkins County, SD",1373,1328,45,3,1396,1360,36,2,1431,1401,30,2,2842,2823,2804,8,30,30,4,50,45,172,705,788,439
46107,SD,"Potter County, SD",1025,995,30,2,1055,1028,27,2,1045,1021,24,2,2480,2471,2438,6,21,22,11,42,42,110,718,563,449
46109,SD,"Roberts County, SD",4824,4545,279,5,4693,4509,184,3,4625,4472,153,3,10250,10178,10163,33,139,142,27,120,117,662,2358,2451,1051
46111,SD,"Sanborn County, SD",1161,1118,43,3,1187,1156,31,2,1210,1185,25,2,2325,2383,2415,7,32,31,2,26,28,129,683,482,269
46115,SD,"Spink County, SD",3095,2982,113,3,3079,2995,84,2,3045,2972,73,2,6347,6273,6235,21,78,77,14,97,84,439,1422,1437,1186
46117,SD,"Stanley County, SD",1915,1848,67,3,1925,1876,49,2,1929,1893,36,1,2969,3017,2999,2,26,27,7,31,28,133,764,601,613
46119,SD,"Sully County, SD",792,772,20,2,812,786,26,3,815,802,13,1,1452,1471,1471,4,15,14,3,15,15,34,367,393,208
46121,SD,"Todd County, SD",3059,2880,179,5,3054,2928,126,4,3017,2904,113,3,9317,9292,9220,48,203,207,23,141,129,984,1450,1572,615
46123,SD,"Tripp County, SD",3004,2920,84,2,3018,2958,60,2,3083,3031,52,1,5603,5566,5565,14,71,74,18,81,75,468,1638,1040,747
46125,SD,"Turner County, SD",4579,4413,166,3,4665,4559,106,2,4761,4672,89,1,8672,8682,8856,17,89,94,22,133,119,502,1953,1944,1539
46127,SD,"Union County, SD",8650,8253,397,4,8646,8384,262,3,8698,8506,192,2,16853,16868,17063,46,160,167,33,160,149,626,3167,3575,3862
46129,SD,"Walworth County, SD",2127,2010,117,5,2158,2057,101,4,2110,2036,74,3,5286,5246,5265,13,68,66,12,83,78,379,1359,1088,947
46135,SD,"Yankton County, SD",11750,11260,490,4,11650,11377,273,2,11717,11504,213,1,23282,23334,23373,66,257,263,66,274,258,1373,5436,5073,4284
46137,SD,"Ziebach County, SD",947,908,39,4,949,912,37,3,950,915,35,3,2392,2400,2395,12,32,34,3,28,38,162,629,487,218
47000,TN,Tennessee,3303230,3056709,246521,7,3323545,3174135,149410,4,3352030,3238559,113471,3,6925619,6968351,7051339,19250,79271,81970,18940,89362,91183,529162,1485813,1326294,1367211
47001,TN,"Anderson County, TN",34361,32045,2316,6,34770,33362,1408,4,35280,34107,1173,3,77302,77567,78913,206,776,796,257,1249,1268,5550,18370,17456,13367
47003,TN,"Bedford County, TN",21064,19383,1681,8,21218,20299,919,4,21523,20792,731,3,50381,51157,51950,174,686,709,124,641,660,5350,13777,7931,5927
47005,TN,"Benton County, TN",6789,6250,539,7,6757,6417,340,5,6755,6477,278,4,15850,15839,16002,34,149,156,61,327,335,1743,5533,2779,1380
47007,TN,"Bledsoe County, TN",4295,3933,362,8,4301,4064,237,5,4361,4130,231,5,14954,14844,14798,35,127,131,37,179,187,2744,5070,2591,1299
47009,TN,"Blount County, TN",63802,59728,4074,6,64485,62134,2351,3,65542,63500,2042,3,135649,137649,139958,318,1281,1331,405,1868,1888,9860,34623,27463,24469
47011,TN,"Bradley County, TN",52621,49160,3461,6,50688,48505,2183,4,50242,48430,1812,3,108820,109769,110616,271,1154,1191,310,1550,1576,9289,23355,24248,16909
47013,TN,"Campbell County, TN",14599,13493,1106,7,14785,14042,743,5,14962,14344,618,4,39301,39409,39584,108,438,448,145,751,763,5663,11328,7676,3746
47015,TN,"Cannon County, TN",6531,6104,427,6,6651,6412,239,3,6863,6655,208,3,14568,14535,14788,37,169,175,49,221,232,1585,4569,2550,1536
47017,TN,"Carroll County, TN",11436,10586,850,7,11572,11023,549,4,11696,11243,453,3,28421,28287,28458,70,293,301,131,519,529,2335,7987,5260,3970
47019,TN,"Carter County, TN",23702,22081,1621,6,24098,23032,1066,4,24060,23185,875,3,56362,56060,56410,120,443,457,207,965,977,5551,15890,12382,8205
47021,TN,"Cheatham County, TN",21386,20166,1220,5,21988,21264,724,3,22607,22006,601,2,41128,41547,41830,105,446,463,122,514,536,3669,11066,7771,6341
47023,TN,"Chester County, TN",8481,8010,471,5,8605,8309,296,3,8540,8286,254,3,17377,17479,17609,34,171,175,43,238,254,1736,4753,2907,1921
47025,TN,"Claiborne County, TN",12794,11843,951,7,12757,12204,553,4,12812,12322,490,3,32066,32146,32431,65,300,310,110,554,571,4124,8881,5741,4201
47027,TN,"Clay County, TN",2706,2496,210,7,2754,2602,152,5,2785,2656,129,4,7588,7572,7620,16,70,70,29,167,165,996,2701,1146,729
47029,TN,"Cocke County, TN",14878,13336,1542,10,14732,13877,855,5,14656,13905,751,5,36039,36370,36879,82,357,375,149,690,736,4217,12245,6360,3213
47031,TN,"Coffee County, TN",25701,23653,2048,8,25219,24136,1083,4,25119,24273,846,3,58134,58933,59728,180,701,720,174,880,875,4751,14776,10497,8886
47033,TN,"Crockett County, TN",6833,6440,393,5,6907,6649,258,3,6845,6628,217,3,13903,13993,13888,43,169,172,53,236,240,1500,3849,2653,1471
47035,TN,"Cumberland County, TN",22807,21086,1721,7,22785,21650,1135,5,23297,22305,992,4,61377,62431,63522,132,492,511,218,1183,1210,5298,18196,14880,8011
47037,TN,"Davidson County, TN",399872,366810,33062,8,404212,386522,17690,4,412906,401294,11612,2,716058,703372,708144,2367,9719,10054,1552,6713,6762,48693,104797,120227,218762
47039,TN,"Decatur County, TN",4446,4063,383,8,4314,4055,259,6,4402,4205,197,4,11437,11413,11564,26,106,107,51,238,243,1294,3567,2125,1313
47041,TN,"DeKalb County, TN",7683,6983,700,9,7771,7402,369,4,7975,7675,300,3,20187,20478,21003,67,245,255,73,332,340,2763,5595,3078,2764
47043,TN,"Dickson County, TN",26369,24793,1576,6,27058,26091,967,3,27918,27093,825,3,54442,55174,55761,148,612,637,160,704,743,4812,14900,10872,6961
47045,TN,"Dyer County, TN",15926,14664,1262,7,16270,15492,778,4,16521,15931,590,3,36709,36586,36410,109,472,483,127,634,645,3030,9308,7565,5048
47047,TN,"Fayette County, TN",19217,18020,1197,6,19264,18428,836,4,19197,18524,673,3,42151,42899,43630,84,410,429,122,554,567,3307,10423,9959,7316
47049,TN,"Fentress County, TN",7527,7054,473,6,7545,7225,320,4,7707,7416,291,3,18533,18837,19332,35,189,189,72,352,374,2607,5245,3243,2106
47051,TN,"Franklin County, TN",19918,18316,1602,8,19434,18642,792,4,19165,18489,676,3,42839,43247,43942,95,432,446,121,646,658,3300,12016,7463,6305
47053,TN,"Gibson County, TN",21821,20340,1481,6,21623,20654,969,4,21566,20803,763,3,50436,50537,50837,117,552,579,156,912,934,4420,13711,9896,6239
47055,TN,"Giles County, TN",14653,13431,1222,8,14698,14032,666,4,14891,14403,488,3,30340,30403,30554,64,293,299,113,518,522,2638,9335,5392,3885
47057,TN,"Grainger County, TN",9499,8821,678,7,9593,9166,427,4,9725,9352,373,3,23563,23833,24277,54,236,241,80,392,398,3402,6889,4286,2375
47059,TN,"Greene County, TN",28923,26566,2357,8,28861,27530,1331,4,28801,27655,1146,4,70333,70603,71405,170,630,653,217,1238,1283,7556,21116,13376,8587
47061,TN,"Grundy County, TN",5133,4622,511,10,4989,4702,287,5,4927,4704,223,4,13539,13586,13783,37,166,168,61,249,256,2078,3966,2064,1403
47063,TN,"Hamblen County, TN",27963,25978,1985,7,27849,26671,1178,4,28128,27104,1024,3,64537,64390,65168,168,728,751,222,1113,1130,6708,17036,12405,7960
47065,TN,"Hamilton County, TN",183241,170226,13015,7,181876,174071,7805,4,183056,176782,6274,3,367242,369027,374682,1054,4337,4492,991,4544,4574,24402,64205,80233,87385
47067,TN,"Hancock County, TN",2196,2016,180,8,2260,2146,114,5,2276,2181,95,4,6625,6777,6845,15,62,62,30,114,119,899,2069,1305,533
47069,TN,"Hardeman County, TN",9298,8559,739,7,8976,8415,561,6,8932,8556,376,4,25432,25276,25529,64,266,278,77,383,395,3302,8043,5047,2099
47071,TN,"Hardin County, TN",10270,9556,714,7,10245,9762,483,4,10064,9660,404,4,26805,26878,27077,47,245,257,109,501,517,3002,8557,4539,3110
47073,TN,"Hawkins County, TN",23412,21611,1801,7,23084,22002,1082,4,23161,22260,901,3,56710,57257,58043,118,493,505,189,1006,1019,5548,17634,11478,6701
47075,TN,"Haywood County, TN",7786,7109,677,8,7648,7182,466,6,7554,7213,341,4,17824,17715,17550,33,177,185,34,276,293,2153,5837,3017,1478
47077,TN,"Henderson County, TN",11900,10942,958,8,11909,11364,545,4,11713,11286,427,3,27827,27916,27929,64,303,319,112,442,449,2557,9034,5067,2613
47079,TN,"Henry County, TN",14150,13150,1000,7,13854,13260,594,4,13556,13016,540,4,32144,32250,32379,68,295,310,121,589,596,3339,10515,5339,4251
47081,TN,"Hickman County, TN",11109,10461,648,5,11436,11013,423,3,11742,11402,340,2,24969,25085,25455,64,262,275,88,391,402,3217,8221,4571,1801
47083,TN,"Houston County, TN",3248,2996,252,7,3201,3039,162,5,3194,3055,139,4,8303,8282,8219,14,77,78,24,165,169,915,2569,1577,769
47085,TN,"Humphreys County, TN",8699,8163,536,6,8629,8274,355,4,8632,8332,300,3,19001,19200,19106,55,204,213,66,313,331,1823,6359,3054,2106
47087,TN,"Jackson County, TN",4720,4346,374,7,4780,4562,218,4,4776,4591,185,3,11634,11777,11989,22,91,92,42,202,206,1625,3922,2024,1153
47089,TN,"Jefferson County, TN",24967,23086,1881,7,24783,23707,1076,4,24998,24088,910,3,54908,55562,56727,127,518,534,167,846,875,5288,14093,11970,7467
47091,TN,"Johnson County, TN",7688,7204,484,6,7702,7414,288,3,7513,7258,255,3,17990,18056,18086,32,149,152,56,299,305,2588,5478,3727,1858
47093,TN,"Knox County, TN",243456,229094,14362,5,246907,238402,8505,3,250987,243788,7199,2,480500,486812,494574,1302,5173,5348,1221,5836,5863,25090,79944,90325,123649
47095,TN,"Lake County, TN",1681,1544,137,8,1666,1564,102,6,1628,1547,81,5,6988,6597,6507,10,54,59,19,126,135,1432,2332,1051,628
47097,TN,"Lauderdale County, TN",9702,8850,852,8,9600,9002,598,6,9395,8955,440,4,25120,24922,24793,80,302,303,77,361,366,3550,8098,4145,1606
47099,TN,"Lawrence County, TN",19274,17780,1494,7,19327,18451,876,4,19229,18560,669,3,44182,44729,45415,106,581,597,170,731,735,4113,12944,7820,4706
47101,TN,"Lewis County, TN",5348,4946,402,7,5546,5269,277,5,5563,5362,201,3,12602,12854,12957,35,127,131,47,209,217,1437,3711,2636,857
47103,TN,"Lincoln County, TN",15985,14638,1347,8,16273,15582,691,4,16608,16073,535,3,35335,35451,36004,83,359,369,127,541,555,3509,10509,5807,4716
47105,TN,"Loudon County, TN",23730,22248,1482,6,23933,23070,863,3,24373,23581,792,3,55127,56672,58181,114,523,540,162,839,832,5092,12733,11014,11345
47107,TN,"McMinn County, TN",23342,21516,1826,7,22523,21446,1077,4,21489,20619,870,4,53344,53907,54719,136,587,610,206,939,944,5248,14294,11189,6708
47109,TN,"McNairy County, TN",8364,7662,702,8,8358,7892,466,5,8382,7998,384,4,25858,25854,25988,65,293,304,117,474,490,2719,8817,4617,2198
47111,TN,"Macon County, TN",11174,10444,730,6,11338,10900,438,3,11649,11292,357,3,25263,25682,26229,68,301,313,73,358,359,3354,8125,3645,1486
47113,TN,"Madison County, TN",49434,45724,3710,7,49933,47600,2333,4,49127,47441,1686,3,98833,98585,99245,265,1178,1208,315,1317,1345,6926,21873,19242,17779
47115,TN,"Marion County, TN",12284,11356,928,7,12179,11620,559,4,12271,11794,477,3,28865,28927,29094,72,295,302,87,446,463,3797,8011,5827,2870
47117,TN,"Marshall County, TN",15495,14078,1417,9,15554,14814,740,4,15607,15093,514,3,34466,35032,35878,102,408,422,80,466,468,2835,9239,7091,4110
47119,TN,"Maury County, TN",51128,46995,4133,8,52069,49457,2612,5,52962,51352,1610,3,101824,105003,108159,353,1295,1342,226,1161,1203,6113,22614,22531,17472
47121,TN,"Meigs County, TN",5198,4746,452,8,5165,4901,264,5,5174,4948,226,4,12807,13029,13272,25,118,119,37,203,211,1553,4092,2606,999
47123,TN,"Monroe County, TN",20174,18554,1620,8,20676,19849,827,4,20967,20244,723,3,46395,46668,47740,122,496,510,153,792,813,5049,13116,9760,5060
47125,TN,"Montgomery County, TN",87044,80451,6593,7,87626,83472,4154,4,88027,84751,3276,3,221265,227841,235201,918,3545,3660,400,1870,1951,8634,36120,49467,40123
47127,TN,"Moore County, TN",3615,3422,193,5,3574,3475,99,2,3687,3596,91,2,6471,6652,6742,18,60,62,17,90,94,625,1893,1111,1087
47129,TN,"Morgan County, TN",7590,7109,481,6,7722,7370,352,4,7845,7546,299,3,21038,21101,21224,43,182,188,68,301,314,2896,7040,3732,1721
47131,TN,"Obion County, TN",12180,11355,825,6,12384,11780,604,4,12696,12207,489,3,30767,30498,30394,72,318,326,91,525,531,3677,9767,4873,3326
47133,TN,"Overton County, TN",9746,9132,614,6,9976,9597,379,3,9977,9639,338,3,22592,22856,23044,62,243,250,86,391,413,2945,7358,3455,2039
47135,TN,"Perry County, TN",2964,2680,284,9,2875,2657,218,7,2765,2616,149,5,8379,8473,8685,20,100,104,25,145,147,1289,2570,1393,523
47137,TN,"Pickett County, TN",2238,2104,134,6,2237,2148,89,4,2180,2097,83,3,5002,5082,5107,10,37,36,19,87,91,789,1434,972,602
47139,TN,"Polk County, TN",7390,6885,505,6,7103,6794,309,4,7045,6782,263,3,17568,17784,17863,38,158,161,66,293,334,2278,4616,4161,1824
47141,TN,"Putnam County, TN",35123,32848,2275,6,35474,34084,1390,3,35382,34192,1190,3,80052,81255,82382,200,861,899,240,1087,1100,5689,18122,13714,13616
47143,TN,"Rhea County, TN",13127,11864,1263,9,13539,12855,684,5,13880,13290,590,4,32934,33205,33730,91,367,379,104,519,554,3761,8622,5959,3942
47145,TN,"Roane County, TN",22988,21528,1460,6,23345,22369,976,4,23755,22885,870,3,53510,54056,55082,111,484,497,210,920,940,3678,14264,13093,8372
47147,TN,"Robertson County, TN",37244,34961,2283,6,38020,36690,1330,3,39207,38096,1111,2,72945,74088,75470,213,855,886,209,929,952,6029,19514,14088,9994
47149,TN,"Rutherford County, TN",186995,173908,13087,7,189949,183066,6883,3,195582,190279,5303,2,343266,351202,360619,989,4135,4281,647,2806,2896,16271,58332,66534,71197
47151,TN,"Scott County, TN",8158,7469,689,8,8044,7615,429,5,8108,7712,396,4,21878,21895,22035,73,252,258,57,348,350,2989,6868,3570,1447
47153,TN,"Sequatchie County, TN",6171,5691,480,7,6119,5831,288,4,6161,5907,254,4,15850,16445,16909,32,167,175,46,206,212,2057,4568,3023,1828
47155,TN,"Sevier County, TN",54138,48854,5284,9,54780,52532,2248,4,54967,53233,1734,3,98562,99435,98789,242,1035,1077,282,1374,1453,9440,24848,22771,13224
47157,TN,"Shelby County, TN",448020,404948,43072,9,446842,415557,31285,7,437751,417985,19766,4,929388,923352,916371,3017,12384,12801,2395,11168,11317,65515,168383,173530,203456
47159,TN,"Smith County, TN",9248,8686,562,6,9461,9127,334,3,9753,9463,290,3,19970,20181,20489,46,217,223,46,284,283,1771,5916,3742,2399
47161,TN,"Stewart County, TN",5416,5072,344,6,5389,5155,234,4,5469,5258,211,3,13711,13830,14035,35,141,143,40,208,212,1276,3944,2474,1953
47163,TN,"Sullivan County, TN",69339,64393,4946,7,68704,65648,3056,4,68794,66378,2416,3,158237,159167,160820,369,1429,1481,590,2701,2741,13485,38514,33836,29670
47165,TN,"Sumner County, TN",103528,96773,6755,6,105679,101971,3708,3,108770,105791,2979,2,197396,200582,203858,546,2167,2239,468,2242,2273,12381,38700,42144,39648
47167,TN,"Tipton County, TN",27648,25803,1845,6,27681,26429,1252,4,27585,26587,998,3,61041,61049,61656,157,643,669,161,759,798,4574,14840,13850,7639
47169,TN,"Trousdale County, TN",5432,5091,341,6,5565,5350,215,3,5724,5553,171,3,11638,11619,12111,28,120,122,29,139,148,1131,3637,2435,757
47171,TN,"Unicoi County, TN",7027,6470,557,7,7063,6701,362,5,7061,6755,306,4,17883,17667,17674,36,137,136,71,365,372,1856,4952,4493,2157
47173,TN,"Union County, TN",7635,7112,523,6,7744,7415,329,4,7857,7560,297,3,19841,19996,20452,38,194,207,76,328,339,2886,5861,3457,1639
47175,TN,"Van Buren County, TN",2015,1843,172,8,2020,1915,105,5,2058,1971,87,4,6174,6277,6429,9,58,61,21,129,130,856,2212,968,449
47177,TN,"Warren County, TN",17249,15717,1532,8,16724,15889,835,5,16402,15721,681,4,41054,41529,42026,117,479,503,114,591,621,4697,12903,6386,3993
47179,TN,"Washington County, TN",60368,56545,3823,6,61175,58875,2300,3,61344,59362,1982,3,133213,133525,136172,296,1215,1256,412,1909,1956,8522,26311,26156,30137
47181,TN,"Wayne County, TN",6360,5925,435,6,6284,6015,269,4,6488,6195,293,4,16222,16336,16308,39,144,146,48,248,256,2172,5587,3233,1408
47183,TN,"Weakley County, TN",15481,14592,889,5,15484,14864,620,4,15294,14764,530,3,32899,32870,33063,72,320,331,92,489,489,2740,9364,4733,4549
47185,TN,"White County, TN",12079,11225,854,7,11905,11415,490,4,12024,11604,420,3,27443,27557,28064,74,293,307,96,457,480,3556,7772,5302,2576
47187,TN,"Williamson County, TN",129525,123397,6128,4,133584,130048,3536,2,138115,134800,3315,2,249538,256209,260815,563,2304,2385,379,1678,1715,6688,20402,33176,98096
47189,TN,"Wilson County, TN",77975,73013,4962,6,79498,76809,2689,3,81932,79774,2158,2,148645,152010,158555,390,1646,1710,361,1579,1615,6965,28718,27967,35702
48000,TX,Texas,13955332,12883803,1071529,7,14311029,13503671,807358,5,14662558,14092833,569725,3,29232474,29558864,30029572,88265,363960,379412,55744,271120,261253,2826181,4563619,5358474,5871195
48001,TX,"Anderson County, TX",23007,21696,1311,5,23405,22268,1137,4,23086,22295,791,3,57926,58233,58064,135,544,564,169,875,830,7632,16454,13360,5095
48003,TX,"Andrews County, TX",9182,8427,755,8,9076,8557,519,5,9455,9154,301,3,18617,18411,18334,66,275,284,28,173,165,2631,3441,2851,2069
48005,TX,"Angelina County, TX",35400,32691,2709,7,35922,33606,2316,6,35480,33856,1624,4,86376,86654,87101,265,1126,1168,294,1248,1219,9177,17909,19353,10223
48007,TX,"Aransas County, TX",9159,8391,768,8,9274,8604,670,7,9294,8806,488,5,23932,24519,24944,38,192,202,99,452,431,2070,6044,5678,4541
48009,TX,"Archer County, TX",3966,3757,209,5,4005,3834,171,4,4013,3878,135,3,8554,8684,8835,15,73,76,23,102,100,563,2295,1815,1353
48011,TX,"Armstrong County, TX",897,858,39,4,927,893,34,3,939,913,26,2,1849,1838,1850,3,22,22,7,38,37,103,356,498,348
48013,TX,"Atascosa County, TX",21612,19761,1851,8,22051,20709,1342,6,22510,21604,906,4,49134,49886,50864,171,627,653,121,617,606,5997,12335,8089,4598
48015,TX,"Austin County, TX",13443,12548,895,6,13784,13019,765,5,14123,13569,554,3,30131,30421,31097,91,344,364,98,360,345,2634,6949,6096,4921
48017,TX,"Bailey County, TX",2383,2269,114,4,2430,2308,122,5,2414,2312,102,4,6868,6803,6779,30,111,110,10,83,81,1217,1481,984,648
48019,TX,"Bandera County, TX",9931,9353,578,5,10311,9819,492,4,10624,10234,390,3,20992,21551,22115,40,174,182,64,332,329,1478,4574,5492,4378
48021,TX,"Bastrop County, TX",42689,40111,2578,6,45560,43508,2052,4,48156,46546,1610,3,98046,102166,106188,283,1180,1246,202,934,909,9731,19484,18605,14394
48023,TX,"Baylor County, TX",1766,1706,60,3,1837,1774,63,3,1925,1873,52,2,3461,3456,3466,9,38,41,14,77,76,398,934,661,488
48025,TX,"Bee County, TX",9808,8833,975,9,9358,8562,796,8,9159,8626,533,5,31049,30828,30394,85,316,327,85,356,365,4470,6908,7419,2529
48027,TX,"Bell County, TX",144576,134426,10150,7,148428,139842,8586,5,149332,142742,6590,4,372229,380241,388386,1483,5995,6266,679,3332,3157,19774,57657,85800,59008
48029,TX,"Bexar County, TX",933208,861839,71369,7,953045,902092,50953,5,978125,941971,36154,3,2015369,2030895,2059530,6018,24930,25988,3562,18714,18031,187071,311876,396349,383551
48031,TX,"Blanco County, TX",6570,6316,254,3,6906,6673,233,3,7133,6934,199,2,11450,11890,12418,15,82,84,28,145,152,855,2493,3099,2235
48033,TX,"Borden County, TX",441,426,15,3,600,586,14,2,701,688,13,1,641,621,585,1,5,5,1,7,7,28,89,105,136
48035,TX,"Bosque County, TX",8234,7783,451,5,8544,8151,393,4,8704,8383,321,3,18245,18495,18697,63,183,188,75,343,332,1373,4347,4974,2408
48037,TX,"Bowie County, TX",38646,35778,2868,7,38964,36664,2300,5,38577,36803,1774,4,92924,92291,92035,284,1054,1096,286,1338,1312,6453,21271,20811,14441
48039,TX,"Brazoria County, TX",178396,163055,15341,8,181069,168804,12265,6,184468,176132,8336,4,373481,378858,388181,1052,4493,4705,696,3335,3219,26922,58256,80131,75268
48041,TX,"Brazos County, TX",117019,110773,6246,5,123982,118912,5070,4,128477,124512,3965,3,234486,237583,242014,654,2626,2747,338,1435,1382,14098,26178,31926,52751
48043,TX,"Brewster County, TX",4093,3822,271,6,4233,4039,194,4,4233,4090,143,3,9553,9459,9343,12,78,81,21,120,112,860,1173,1830,3297
48045,TX,"Briscoe County, TX",552,526,26,4,585,557,28,4,603,582,21,3,1419,1400,1431,6,11,12,7,23,26,143,345,327,151
48047,TX,"Brooks County, TX",2588,2311,277,10,2508,2280,228,9,2381,2239,142,6,7057,6994,6906,26,93,96,15,118,112,1491,1257,1136,855
48049,TX,"Brown County, TX",15214,14226,988,6,15443,14637,806,5,15271,14609,662,4,38048,38142,38373,95,400,415,141,693,658,3460,9231,8664,5142
48051,TX,"Burleson County, TX",8122,7604,518,6,8589,8165,424,4,8857,8539,318,3,17680,18110,18657,59,202,207,52,285,286,2138,4229,3446,2619
48053,TX,"Burnet County, TX",23659,22531,1128,4,24809,23870,939,3,25614,24857,757,3,49473,51080,52502,119,487,513,148,690,648,3966,10565,10573,9677
48055,TX,"Caldwell County, TX",18928,17696,1232,6,20192,19196,996,4,21275,20540,735,3,45949,46904,47848,128,618,642,134,513,485,5883,11351,7544,4726
48057,TX,"Calhoun County, TX",11916,11220,696,5,12291,11685,606,4,12272,11822,450,3,20063,19798,19706,75,235,247,55,274,272,2317,4401,4539,2376
48059,TX,"Callahan County, TX",5978,5652,326,5,6177,5886,291,4,6279,6055,224,3,13744,14078,14210,27,128,130,49,249,238,1019,3317,3243,2189
48061,TX,"Cameron County, TX",170354,153091,17263,10,176318,162189,14129,8,177545,167496,10049,5,421445,423124,425208,1473,5779,6007,803,4109,3970,75925,64783,60759,47124
48063,TX,"Camp County, TX",4982,4613,369,7,5131,4827,304,5,5137,4908,229,4,12427,12594,12716,31,168,182,51,221,217,1033,2758,2533,1863
48065,TX,"Carson County, TX",2871,2750,121,4,2979,2862,117,3,3016,2924,92,3,5791,5708,5784,8,51,51,21,103,97,302,1302,1379,1054
48067,TX,"Cass County, TX",12206,11237,969,7,12432,11608,824,6,12022,11461,561,4,28436,28557,28539,77,321,336,105,585,559,2619,8624,5324,3473
48069,TX,"Castro County, TX",3268,3149,119,3,3400,3279,121,3,3351,3247,104,3,7336,7362,7298,18,110,112,22,92,94,1078,1475,1013,996
48071,TX,"Chambers County, TX",20331,18424,1907,9,20767,19080,1687,8,21015,19906,1109,5,47025,48721,51288,116,555,582,97,417,402,3019,7403,11282,6828
48073,TX,"Cherokee County, TX",21108,19429,1679,8,20956,19622,1334,6,20574,19665,909,4,50488,51163,51645,165,700,721,151,747,752,6438,10009,10761,5734
48075,TX,"Childress County, TX",3013,2901,112,3,3027,2916,111,3,3189,3099,90,2,6662,6781,6809,12,60,65,11,91,91,856,1805,1391,943
48077,TX,"Clay County, TX",4800,4534,266,5,4866,4624,242,5,4867,4680,187,3,10250,10315,10486,31,94,98,32,158,156,596,2562,2586,1727
48079,TX,"Cochran County, TX",1112,1032,80,7,1084,1016,68,6,1137,1082,55,4,2557,2491,2526,10,44,45,6,39,43,551,562,413,163
48081,TX,"Coke County, TX",1361,1286,75,5,1386,1320,66,4,1535,1482,53,3,3295,3313,3333,14,36,36,9,68,68,373,766,688,469
48083,TX,"Coleman County, TX",2861,2650,211,7,2970,2793,177,6,3046,2914,132,4,7686,7736,7850,23,80,83,30,189,192,825,1844,2028,1104
48085,TX,"Collin County, TX",579363,543037,36326,6,600965,574762,26203,4,625323,605500,19823,3,1075654,1114450,1158696,2786,11565,12084,1302,6318,6042,41845,100786,176665,366408
48087,TX,"Collingsworth County, TX",1067,1022,45,4,1100,1051,49,4,1091,1053,38,3,2638,2603,2568,7,29,27,7,49,49,478,434,523,444
48089,TX,"Colorado County, TX",9662,9124,538,5,9966,9488,478,4,10213,9854,359,3,20558,20592,20754,35,237,255,67,338,325,2179,4986,3884,2887
48091,TX,"Comal County, TX",77273,72559,4714,6,79751,76112,3639,4,82222,79381,2841,3,163640,174891,184642,389,1684,1758,353,1816,1712,6759,26139,33122,43288
48093,TX,"Comanche County, TX",5617,5308,309,5,6061,5780,281,4,6323,6103,220,3,13628,13804,13878,38,158,162,44,249,233,1364,3042,3207,1823
48095,TX,"Concho County, TX",1329,1269,60,4,1358,1300,58,4,1334,1292,42,3,3303,3336,3340,11,23,24,9,38,39,618,944,619,321
48097,TX,"Cooke County, TX",19229,17861,1368,7,19511,18522,989,5,20022,19350,672,3,41744,42408,43050,110,500,525,106,522,496,3391,8911,9534,6175
48099,TX,"Coryell County, TX",23776,22199,1577,6,24505,23099,1406,5,24681,23578,1103,4,83146,84406,85057,229,922,958,147,675,671,5622,14959,22310,8960
48101,TX,"Cottle County, TX",567,539,28,4,638,609,29,4,862,839,23,2,1364,1357,1307,2,10,9,11,29,32,148,286,380,199
48103,TX,"Crane County, TX",1623,1401,222,13,1630,1479,151,9,1627,1546,81,5,4673,4639,4546,11,61,60,9,53,51,706,1079,688,411
48105,TX,"Crockett County, TX",1548,1410,138,8,1476,1378,98,6,1434,1377,57,4,3094,3015,2943,6,43,44,16,62,61,453,850,565,360
48107,TX,"Crosby County, TX",2291,2168,123,5,2396,2262,134,5,2424,2324,100,4,5093,5085,4998,18,72,74,18,101,101,788,1286,876,500
48109,TX,"Culberson County, TX",1127,1053,74,6,1076,1024,52,4,1153,1120,33,2,2185,2182,2155,5,30,31,8,36,37,554,597,113,263
48111,TX,"Dallam County, TX",3730,3627,103,2,3828,3724,104,2,3869,3778,91,2,7126,7188,7241,43,182,188,14,82,81,1292,1361,1021,685
48113,TX,"Dallas County, TX",1330656,1226780,103876,7,1375488,1299051,76437,5,1420674,1368043,52631,3,2609966,2587954,2600840,8665,35166,36624,4837,21421,20384,323421,379095,422320,552919
48115,TX,"Dawson County, TX",4569,4170,399,8,4636,4320,316,6,4538,4340,198,4,12473,12412,12130,55,178,187,26,188,183,2272,2576,1878,1067
48117,TX,"Deaf Smith County, TX",8480,8174,306,3,8838,8509,329,3,9015,8747,268,3,18526,18345,18377,87,312,323,44,222,217,2820,4419,2454,1253
48119,TX,"Delta County, TX",2391,2259,132,5,2461,2340,121,4,2515,2414,101,4,5222,5337,5406,14,64,65,18,95,96,451,1136,1182,796
48121,TX,"Denton County, TX",511748,478783,32965,6,529962,506554,23408,4,551484,533815,17669,3,914324,943857,977281,2468,10156,10620,1109,5378,5153,39578,99340,170427,277846
48123,TX,"DeWitt County, TX",9184,8626,558,6,9482,9020,462,4,9113,8801,312,3,19835,19949,19772,55,231,229,65,308,313,2351,5681,4146,1761
48125,TX,"Dickens County, TX",659,618,41,6,691,655,36,5,694,661,33,4,1758,1734,1726,3,16,16,4,41,35,190,384,361,236
48127,TX,"Dimmit County, TX",6467,6054,413,6,5936,5606,330,5,6154,5919,235,3,8577,8479,8387,38,139,144,28,133,134,1734,1793,1273,719
48129,TX,"Donley County, TX",1413,1351,62,4,1458,1397,61,4,1492,1439,53,3,3279,3364,3339,8,34,35,6,61,59,296,677,805,332
48131,TX,"Duval County, TX",4829,4240,589,12,5480,5041,439,8,5051,4826,225,4,9807,10003,9888,24,126,131,29,149,159,1766,2134,1926,565
48133,TX,"Eastland County, TX",7324,6830,494,6,7432,7005,427,5,6694,6389,305,4,17775,17834,17944,53,203,212,63,344,345,1817,3526,4184,2592
48135,TX,"Ector County, TX",82625,73476,9149,11,80993,74514,6479,8,83462,80225,3237,3,165485,160764,160869,667,2709,2822,325,1691,1627,22737,28594,29092,15625
48137,TX,"Edwards County, TX",1235,1191,44,3,1289,1233,56,4,1201,1167,34,2,1424,1431,1422,4,18,19,6,35,36,198,200,326,192
48139,TX,"Ellis County, TX",95137,89443,5694,6,99220,94707,4513,4,103316,99727,3589,3,194295,203107,212182,557,2431,2549,401,1843,1771,15256,33040,41192,31862
48141,TX,"El Paso County, TX",361760,331684,30076,8,366812,344209,22603,6,370586,354817,15769,4,866547,868086,868763,2686,10795,11229,1552,8131,7781,107438,126250,166127,130896
48143,TX,"Erath County, TX",19939,18793,1146,5,20656,19717,939,4,21159,20423,736,3,42716,43389,43895,105,441,463,87,429,428,3082,6922,7233,7690
48145,TX,"Falls County, TX",6384,5994,390,6,6715,6358,357,5,6839,6562,277,4,16954,17099,17049,43,170,177,52,228,223,2461,4022,4002,1520
48147,TX,"Fannin County, TX",16689,15899,790,4,17205,16504,701,4,17379,16774,605,3,35798,36716,37125,102,366,382,104,569,550,3522,8760,8012,4647
48149,TX,"Fayette County, TX",11745,11190,555,4,11975,11457,518,4,11952,11538,414,3,24471,24669,24913,54,231,244,98,404,389,2063,6953,4779,4130
48151,TX,"Fisher County, TX",1593,1522,71,4,1625,1556,69,4,1641,1584,57,3,3676,3678,3622,12,35,33,9,78,74,357,917,836,514
48153,TX,"Floyd County, TX",2492,2337,155,6,2510,2366,144,5,2457,2356,101,4,5368,5299,5235,14,63,64,22,105,113,936,1053,1034,531
48155,TX,"Foard County, TX",575,551,24,4,590,570,20,3,562,544,18,3,1085,1052,1057,1,11,10,4,32,29,200,193,291,140
48157,TX,"Fort Bend County, TX",402949,372145,30804,7,409802,385666,24136,5,418649,402222,16427,3,829036,860124,889146,2185,8801,9180,1037,5000,4773,46630,93130,129713,249367
48159,TX,"Franklin County, TX",4814,4556,258,5,5253,5020,233,4,5361,5187,174,3,10371,10472,10618,25,111,109,33,158,152,694,1968,2403,2085
48161,TX,"Freestone County, TX",6317,5788,529,8,6370,5911,459,7,6329,5991,338,5,19445,19784,19950,36,185,194,67,288,278,2400,4619,4594,2206
48163,TX,"Frio County, TX",9524,8983,541,5,9490,9034,456,4,9418,9097,321,3,18409,17548,17815,51,220,230,35,216,208,4109,4497,2258,1061
48165,TX,"Gaines County, TX",9701,9154,547,5,9849,9396,453,4,10148,9845,303,3,21699,21881,22181,108,451,475,38,172,175,4378,3707,2081,1222
48167,TX,"Galveston County, TX",163981,149565,14416,8,165872,154992,10880,6,169058,161647,7411,4,351559,355309,357117,918,3812,3963,819,3709,3568,23682,56847,75386,77604
48169,TX,"Garza County, TX",2007,1870,137,6,2009,1910,99,4,1964,1883,81,4,5817,6269,6262,14,48,49,14,72,73,1445,1385,948,498
48171,TX,"Gillespie County, TX",13231,12600,631,4,14022,13549,473,3,14654,14270,384,2,26742,27282,27477,66,247,251,94,429,400,2033,5147,5467,6878
48173,TX,"Glasscock County, TX",802,773,29,3,818,793,25,3,876,853,23,2,1117,1142,1164,7,15,16,4,12,11,204,152,219,256
48175,TX,"Goliad County, TX",3126,2882,244,7,3185,2978,207,6,3198,3058,140,4,7021,7146,7131,14,59,58,17,86,88,826,1459,1869,921
48177,TX,"Gonzales County, TX",9498,8983,515,5,9653,9235,418,4,9527,9218,309,3,19679,19655,19832,86,280,288,68,277,274,3011,5506,2537,1736
48179,TX,"Gray County, TX",7751,7120,631,8,7741,7232,509,6,7686,7343,343,4,21198,21085,21015,67,252,253,59,340,324,2678,4683,4685,2066
48181,TX,"Grayson County, TX",63952,60181,3771,5,65146,62098,3048,4,65789,63365,2424,3,136100,139561,143131,405,1645,1717,392,1974,1899,8735,27226,34825,19682
48183,TX,"Gregg County, TX",56310,51620,4690,8,56494,52896,3598,6,56931,54513,2418,4,124241,124052,125443,388,1607,1677,374,1828,1762,11316,22532,29245,16964
48185,TX,"Grimes County, TX",11074,10177,897,8,11248,10505,743,6,11460,10943,517,4,29430,30106,30754,69,363,385,100,374,377,3677,6733,6119,3526
48187,TX,"Guadalupe County, TX",80648,75690,4958,6,82879,79163,3716,4,85585,82694,2891,3,173686,177254,182760,445,1847,1920,301,1575,1526,12020,34022,33949,32216
48189,TX,"Hale County, TX",11706,10914,792,6,11987,11259,728,6,11674,11100,574,4,32465,32234,31827,107,412,425,70,435,431,5010,6483,5360,3382
48191,TX,"Hall County, TX",1064,1002,62,5,1090,1030,60,5,1093,1047,46,4,2797,2845,2810,1,25,27,10,57,55,347,657,604,385
48193,TX,"Hamilton County, TX",3732,3561,171,4,3849,3691,158,4,3889,3757,132,3,8247,8238,8298,14,78,81,19,138,141,743,2025,1682,1229
48195,TX,"Hansford County, TX",2473,2387,86,3,2571,2491,80,3,2878,2809,69,2,5260,5138,5151,23,70,74,12,60,63,883,921,667,767
48197,TX,"Hardeman County, TX",1703,1628,75,4,1747,1672,75,4,1792,1729,63,3,3559,3544,3516,8,43,43,18,62,59,359,913,808,391
48199,TX,"Hardin County, TX",25209,22953,2256,8,24900,22945,1955,7,24912,23629,1283,5,56344,57044,57811,160,686,712,169,780,745,4385,14979,11488,7118
48201,TX,"Harris County, TX",2277130,2072308,204822,9,2295634,2149355,146279,6,2339651,2240795,98856,4,4734505,4735287,4780913,15208,62320,64873,7762,36259,34756,545847,685095,800325,979189
48203,TX,"Harrison County, TX",28995,26708,2287,7,28789,26903,1886,6,28968,27675,1293,4,68798,69454,69955,165,741,775,196,862,846,5449,14955,15594,9641
48205,TX,"Hartley County, TX",2610,2558,52,2,2749,2689,60,2,2618,2566,52,2,5349,5389,5208,14,60,62,10,49,53,568,1439,1110,937
48207,TX,"Haskell County, TX",2666,2552,114,4,2765,2654,111,4,2771,2689,82,3,5432,5392,5403,12,46,46,14,97,100,805,1457,873,674
48209,TX,"Hays County, TX",123417,115665,7752,6,130916,125498,5418,4,138543,134363,4180,3,243967,256065,269225,686,2806,2932,306,1575,1538,13589,32279,41538,55120
48211,TX,"Hemphill County, TX",1791,1709,82,4,1648,1575,73,4,1633,1579,54,3,3363,3315,3217,6,32,32,11,27,26,331,815,642,495
48213,TX,"Henderson County, TX",37020,34634,2386,6,38453,36463,1990,5,39001,37516,1485,3,82394,83590,84511,212,933,975,301,1517,1478,8749,19387,19071,10508
48215,TX,"Hidalgo County, TX",359516,317497,42019,11,368355,334866,33489,9,371985,347873,24112,6,872806,880633,888367,3107,13088,13612,1115,7001,6716,159988,118834,115338,95429
48217,TX,"Hill County, TX",16248,15222,1026,6,17019,16164,855,5,17859,17169,690,3,35962,36430,37329,77,402,421,111,633,619,3551,8388,8223,4231
48219,TX,"Hockley County, TX",10648,9799,849,8,10747,10112,635,5,10781,10387,394,3,21503,21256,21161,65,278,287,63,325,318,3179,3584,4486,2306
48221,TX,"Hood County, TX",27946,26097,1849,6,29086,27578,1508,5,29922,28800,1122,3,62054,64263,66373,150,606,636,187,994,961,3543,12335,14654,13334
48223,TX,"Hopkins County, TX",17439,16546,893,5,17960,17174,786,4,18388,17741,647,3,36824,37237,37804,111,444,468,107,550,531,3402,8558,7490,5156
48225,TX,"Houston County, TX",10062,9533,529,5,10666,10147,519,4,10548,10173,375,3,22055,21958,21950,52,211,217,93,383,372,3337,5977,4681,2342
48227,TX,"Howard County, TX",13423,12330,1093,8,13354,12497,857,6,13114,12451,663,5,34812,34336,33672,104,386,396,99,481,468,4606,8037,7785,3247
48229,TX,"Hudspeth County, TX",1845,1695,150,8,1864,1757,107,5,1889,1814,75,4,3203,3289,3432,8,38,37,13,38,41,1156,527,420,194
48231,TX,"Hunt County, TX",43201,40350,2851,6,45074,42732,2342,5,46815,44985,1830,3,100257,103458,108282,279,1230,1289,292,1319,1258,8310,22914,20308,13906
48233,TX,"Hutchinson County, TX",8487,7878,609,7,8623,8110,513,5,8487,8109,378,4,20568,20411,20215,65,226,234,60,347,334,1875,4503,5010,2262
48235,TX,"Irion County, TX",757,711,46,6,784,746,38,4,790,766,24,3,1511,1531,1530,1,13,19,3,23,23,121,281,471,196
48237,TX,"Jack County, TX",3391,3153,238,7,3425,3238,187,5,3443,3313,130,3,8486,8718,8922,19,84,86,35,108,111,1063,2212,1656,855
48239,TX,"Jackson County, TX",7273,6851,422,5,7186,6825,361,5,7127,6879,248,3,14992,15097,15142,38,208,223,41,188,183,1933,3289,3188,1541
48241,TX,"Jasper County, TX",12830,11386,1444,11,12872,11640,1232,9,12645,11837,808,6,32921,32570,32484,87,367,378,121,579,577,3578,10088,6354,3030
48243,TX,"Jeff Davis County, TX",958,909,49,5,1036,991,45,4,1016,981,35,3,1986,1959,1903,4,15,15,8,33,34,205,274,635,417
48245,TX,"Jefferson County, TX",104671,92107,12564,12,102139,92147,9992,9,101171,94883,6288,6,256118,253531,250830,748,3086,3208,716,3218,3111,25802,54607,57429,32646
48247,TX,"Jim Hogg County, TX",1875,1695,180,9,1867,1705,162,8,1802,1705,97,5,4846,4797,4763,13,63,67,9,63,67,693,930,591,337
48249,TX,"Jim Wells County, TX",16097,14001,2096,13,15664,14117,1547,9,15401,14520,881,5,38877,38923,38826,132,504,531,95,535,555,5266,9377,6458,3907
48251,TX,"Johnson County, TX",83334,77918,5416,6,86366,82164,4202,4,89046,85941,3105,3,180945,187442,195506,491,2190,2295,375,2069,1969,15790,40709,35260,23626
48253,TX,"Jones County, TX",5618,5220,398,7,5764,5410,354,6,5826,5575,251,4,19678,19809,19935,40,143,152,57,280,270,2815,5655,4347,1771
48255,TX,"Karnes County, TX",6986,6546,440,6,6878,6523,355,5,6647,6427,220,3,14763,14714,14836,40,159,163,41,197,200,2523,3751,2241,1613
48257,TX,"Kaufman County, TX",69275,64843,4432,6,72151,68594,3557,4,75098,72291,2807,3,147126,158216,172366,467,2099,2216,285,1457,1394,12144,26567,30782,19818
48259,TX,"Kendall County, TX",22148,21022,1126,5,22972,22077,895,3,23745,23004,741,3,44547,46851,48973,89,400,424,109,487,465,2038,4431,9396,14361
48261,TX,"Kenedy County, TX",180,170,10,5,186,175,11,5,147,138,9,6,351,342,358,1,2,2,0,4,1,84,15,0,4
48263,TX,"Kent County, TX",461,443,18,3,454,441,13,2,627,614,13,2,761,746,740,0,7,8,1,19,20,48,103,140,142
48265,TX,"Kerr County, TX",21665,20396,1269,5,22248,21234,1014,4,22343,21542,801,3,52691,53136,53741,107,482,502,193,901,852,3745,10920,12344,11108
48267,TX,"Kimble County, TX",1829,1737,92,5,1889,1809,80,4,1836,1774,62,3,4291,4350,4422,15,44,45,14,68,72,460,924,925,903
48269,TX,"King County, TX",236,232,4,1,465,461,4,0,582,577,5,0,266,256,233,1,3,2,0,1,1,39,59,26,42
48271,TX,"Kinney County, TX",1309,1231,78,6,1257,1186,71,5,1267,1207,60,4,3124,3117,3128,2,24,25,7,48,52,367,630,1045,409
48273,TX,"Kleberg County, TX",13223,12101,1122,8,13263,12330,933,7,13092,12466,626,4,30977,30642,30362,86,357,367,62,352,355,3393,5754,4332,4022
48275,TX,"Knox County, TX",1446,1365,81,5,1479,1410,69,4,1484,1426,58,3,3346,3307,3273,11,43,43,21,78,78,436,715,801,343
48277,TX,"Lamar County, TX",23519,22003,1516,6,24707,23344,1363,5,24512,23466,1046,4,50126,50305,50484,145,631,671,167,836,803,4292,11724,11514,6666
48279,TX,"Lamb County, TX",5196,4925,271,5,5249,4985,264,5,5290,5081,209,4,13005,12886,12724,42,174,175,32,217,198,1968,2981,2295,1049
48281,TX,"Lampasas County, TX",9018,8533,485,5,9350,8896,454,4,9428,9080,348,3,21707,22213,22785,39,203,205,62,311,317,1312,4729,6431,2774
48283,TX,"La Salle County, TX",3726,3475,251,6,3816,3653,163,4,4113,3996,117,2,6664,6716,6604,22,77,76,16,83,85,1435,2076,736,356
48285,TX,"Lavaca County, TX",8391,7951,440,5,8701,8307,394,4,9159,8853,306,3,20348,20490,20589,55,229,236,73,328,308,1911,5530,4027,2498
48287,TX,"Lee County, TX",9141,8688,453,5,9035,8641,394,4,8734,8425,309,3,17502,17671,17954,62,195,207,56,236,226,1587,4960,4003,1759
48289,TX,"Leon County, TX",6079,5603,476,7,6223,5787,436,7,6057,5743,314,5,15731,15985,16209,35,188,191,53,269,270,1857,4034,3362,1924
48291,TX,"Liberty County, TX",34337,30740,3597,10,35008,31868,3140,9,35293,33230,2063,5,92465,97382,101992,293,1274,1340,188,1051,1052,12602,22359,16804,5664
48293,TX,"Limestone County, TX",8300,7707,593,7,8547,8019,528,6,8399,8013,386,4,22139,22125,22253,59,252,267,72,361,376,2394,5395,5233,2422
48295,TX,"Lipscomb County, TX",1520,1457,63,4,1515,1457,58,3,1464,1419,45,3,3036,2907,2854,5,30,32,4,33,36,268,568,578,483
48297,TX,"Live Oak County, TX",5152,4764,388,7,4959,4629,330,6,4869,4666,203,4,11349,11383,11428,34,106,110,33,166,166,1886,2570,2599,1034
48299,TX,"Llano County, TX",8444,7957,487,5,9005,8565,440,4,9354,8999,355,3,21285,22013,22540,33,187,206,78,428,401,1822,4424,5364,5168
48301,TX,"Loving County, TX",296,291,5,1,488,483,5,1,874,869,5,0,65,57,51,0,0,0,0,0,0,3,9,40,0
48303,TX,"Lubbock County, TX",156742,147715,9027,5,161697,154339,7358,4,163740,158245,5495,3,311564,314597,317561,981,3927,4086,747,3541,3440,22192,47375,54617,58795
48305,TX,"Lynn County, TX",2739,2589,150,5,2822,2700,122,4,2876,2774,102,3,5610,5652,5724,18,77,75,18,95,98,760,1035,994,838
48307,TX,"McCulloch County, TX",3205,2963,242,7,3187,2984,203,6,3151,3019,132,4,7591,7532,7497,12,70,73,20,148,151,1061,1796,1821,763
48309,TX,"McLennan County, TX",119107,111672,7435,6,124783,118750,6033,4,127001,122457,4544,3,261177,263714,266836,773,3210,3362,602,2966,2895,21411,42373,52268,41378
48311,TX,"McMullen County, TX",716,696,20,2,753,736,17,2,902,886,16,1,598,597,576,3,7,8,4,14,17,49,224,134,74
48313,TX,"Madison County, TX",4465,4144,321,7,4711,4418,293,6,4741,4536,205,4,13464,13498,13661,37,175,182,40,180,176,2032,3674,2543,1107
48315,TX,"Marion County, TX",4230,3878,352,8,4272,3982,290,6,4208,3999,209,5,9751,9618,9560,21,88,89,50,201,199,923,2825,2267,1090
48317,TX,"Martin County, TX",2553,2397,156,6,2634,2508,126,4,2798,2711,87,3,5252,5208,5217,21,79,81,16,64,67,593,1028,812,647
48319,TX,"Mason County, TX",1724,1628,96,5,1808,1722,86,4,1827,1766,61,3,3968,3929,3982,7,33,32,9,62,62,480,557,735,952
48321,TX,"Matagorda County, TX",16470,14733,1737,10,16600,15248,1352,8,17150,16138,1012,5,36280,36366,36125,135,499,520,97,489,474,4434,7060,7608,4712
48323,TX,"Maverick County, TX",24254,20577,3677,15,23847,20913,2934,12,23405,21552,1853,7,57873,57841,57843,244,963,999,116,651,650,12023,8684,7004,5277
48325,TX,"Medina County, TX",21320,19966,1354,6,22011,20904,1107,5,22681,21819,862,3,50939,52322,53723,121,583,608,109,567,568,4830,10919,10623,7696
48327,TX,"Menard County, TX",862,818,44,5,851,810,41,4,851,819,32,3,1961,1964,1968,4,16,15,14,44,44,271,385,446,411
48329,TX,"Midland County, TX",98443,90501,7942,8,100271,94718,5553,5,105948,102848,3100,2,170348,168206,171999,728,2811,2933,278,1426,1367,16086,25181,32734,29891
48331,TX,"Milam County, TX",9675,8979,696,7,10260,9663,597,5,10297,9859,438,4,24775,25189,25628,77,288,301,68,384,373,2349,6905,4872,2732
48333,TX,"Mills County, TX",1877,1800,77,4,1927,1841,86,4,1910,1829,81,4,4447,4497,4500,12,34,35,21,84,83,497,1047,1004,838
48335,TX,"Mitchell County, TX",2340,2155,185,7,2357,2192,165,7,2309,2207,102,4,9014,9050,8943,22,70,72,16,105,101,946,2307,1547,529
48337,TX,"Montague County, TX",9057,8454,603,6,9330,8847,483,5,9242,8909,333,3,19994,20430,21063,47,201,204,79,384,376,1889,5129,4508,2445
48339,TX,"Montgomery County, TX",289844,268188,21656,7,295262,278284,16978,5,301853,290062,11791,3,625243,650261,678490,1833,7588,7940,1192,5300,5094,41383,91933,119813,144712
48341,TX,"Moore County, TX",10553,10158,395,3,11129,10754,375,3,11322,11025,297,2,21264,21122,20996,76,374,388,40,194,203,4126,3914,2880,1624
48343,TX,"Morris County, TX",4851,4305,546,11,4634,4163,471,10,4473,4193,280,6,11972,12009,12083,26,126,126,41,213,216,827,3450,2883,1056
48345,TX,"Motley County, TX",433,413,20,4,451,428,23,5,512,491,21,4,1063,1065,1032,5,12,12,4,31,25,123,268,328,198
48347,TX,"Nacogdoches County, TX",27811,25979,1832,6,28454,26890,1564,5,28000,26801,1199,4,64619,64699,64862,196,801,833,186,817,783,5521,11478,11339,9294
48349,TX,"Navarro County, TX",23281,21838,1443,6,23779,22557,1222,5,23597,22683,914,3,52828,53616,54636,145,674,708,125,701,678,6667,10106,11262,5600
48351,TX,"Newton County, TX",4975,4419,556,11,4921,4418,503,10,4883,4550,333,6,12157,12202,12052,26,113,116,51,234,226,1578,3794,2699,730
48353,TX,"Nolan County, TX",7048,6670,378,5,7214,6872,342,4,6782,6528,254,3,14723,14600,14473,50,188,196,54,230,228,1677,3134,3131,1548
48355,TX,"Nueces County, TX",164344,149667,14677,8,163979,152779,11200,6,164095,156419,7676,4,353376,353230,351674,1041,4278,4457,769,4079,3979,36787,67992,75893,50795
48357,TX,"Ochiltree County, TX",4024,3789,235,5,3993,3810,183,4,3944,3810,134,3,9954,9763,9606,28,124,126,19,99,100,1407,2018,1467,1135
48359,TX,"Oldham County, TX",893,858,35,3,924,891,33,3,939,911,28,3,1764,1730,1752,7,26,24,4,20,20,165,411,424,313
48361,TX,"Orange County, TX",35695,31907,3788,10,35027,31934,3093,8,34871,32877,1994,5,84747,84641,84934,249,1014,1059,272,1262,1210,6289,20535,20577,9547
48363,TX,"Palo Pinto County, TX",13160,12233,927,7,13007,12269,738,5,13135,12639,496,3,28445,28676,29239,80,337,352,115,481,466,2543,7074,6357,3382
48365,TX,"Panola County, TX",9395,8604,791,8,9777,9131,646,6,9629,9187,442,4,22492,22538,22677,77,243,261,108,394,389,2657,4633,5974,2072
48367,TX,"Parker County, TX",69486,65436,4050,5,72275,69048,3227,4,74625,72184,2441,3,149547,156966,165834,385,1681,1764,334,1591,1536,10106,26714,32672,28286
48369,TX,"Parmer County, TX",4843,4718,125,2,5023,4876,147,2,5134,5010,124,2,9854,9779,9620,46,153,158,30,111,126,1662,1638,1802,1121
48371,TX,"Pecos County, TX",6400,5870,530,8,6251,5820,431,6,6322,6067,255,4,15185,15126,14735,52,193,205,33,202,191,2538,3821,2617,1164
48373,TX,"Polk County, TX",18341,16723,1618,8,18721,17241,1480,7,18708,17672,1036,5,50494,51816,53255,104,496,534,205,910,907,6999,13350,10670,4661
48375,TX,"Potter County, TX",53122,50174,2948,5,54642,52270,2372,4,55077,53314,1763,3,118272,116538,115645,395,1548,1614,336,1690,1621,17769,23774,22080,11962
48377,TX,"Presidio County, TX",3196,2720,476,14,3118,2801,317,10,3096,2905,191,6,6109,6115,5939,14,80,83,6,71,72,1938,523,865,719
48379,TX,"Rains County, TX",5989,5707,282,4,6371,6120,251,3,6519,6296,223,3,12178,12449,12823,27,112,114,46,206,206,1218,3255,2773,1682
48381,TX,"Randall County, TX",72962,69705,3257,4,75142,72453,2689,3,76100,73938,2162,2,141342,144039,146140,406,1627,1694,290,1510,1449,5772,21697,34814,29610
48383,TX,"Reagan County, TX",1800,1624,176,9,1677,1554,123,7,1634,1576,58,3,3378,3228,3135,18,50,53,4,36,35,286,835,542,265
48385,TX,"Real County, TX",1081,1010,71,6,1153,1084,69,6,1143,1090,53,4,2743,2806,2840,9,27,27,12,73,73,213,753,698,317
48387,TX,"Red River County, TX",5100,4774,326,6,5346,5028,318,5,5144,4881,263,5,11560,11547,11542,37,123,124,63,265,258,1052,3552,2728,1267
48389,TX,"Reeves County, TX",8794,8160,634,7,8556,8063,493,5,8525,8235,290,3,14763,13002,12905,56,192,201,29,164,157,2867,3727,2191,927
48391,TX,"Refugio County, TX",3041,2790,251,8,3050,2848,202,6,2968,2828,140,4,6742,6700,6632,19,56,56,27,113,119,887,1916,1431,491
48393,TX,"Roberts County, TX",402,384,18,4,402,385,17,4,399,384,15,3,822,798,803,0,7,11,1,12,10,36,189,190,145
48395,TX,"Robertson County, TX",7301,6831,470,6,7730,7327,403,5,7971,7665,306,3,16771,16948,17153,55,208,209,53,257,258,1726,4392,3300,2043
48397,TX,"Rockwall County, TX",54591,51350,3241,5,56857,54381,2476,4,59221,57261,1960,3,109136,116549,123208,270,1188,1241,166,855,813,4418,12321,21842,30040
48399,TX,"Runnels County, TX",4523,4300,223,4,4681,4487,194,4,4694,4539,155,3,9919,9886,9859,24,104,109,41,181,186,1147,2424,2052,1203
48401,TX,"Rusk County, TX",21933,20318,1615,7,22175,20854,1321,6,22417,21486,931,4,52257,53071,53333,164,552,586,151,760,724,5570,11939,12772,5750
48403,TX,"Sabine County, TX",3895,3472,423,10,4006,3631,375,9,3960,3682,278,7,9888,9989,10048,26,105,110,49,234,220,1033,2660,2487,1402
48405,TX,"San Augustine County, TX",3017,2727,290,9,2986,2743,243,8,3094,2914,180,5,7923,7900,7857,14,84,85,39,191,190,1098,2508,1496,700
48407,TX,"San Jacinto County, TX",11599,10656,943,8,11951,11079,872,7,12048,11464,584,4,27531,27829,28348,77,289,298,73,446,444,2990,7535,5993,2761
48409,TX,"San Patricio County, TX",29385,26377,3008,10,29437,26880,2557,8,29297,27535,1762,6,68838,69701,69954,206,883,913,155,851,843,8078,14265,14588,7343
48411,TX,"San Saba County, TX",2187,2074,113,5,2221,2117,104,4,2237,2158,79,3,5722,5824,5824,6,44,44,14,105,101,726,1514,1044,671
48413,TX,"Schleicher County, TX",1209,1125,84,6,1198,1132,66,5,1244,1200,44,3,2445,2443,2357,6,32,30,7,28,31,259,486,685,288
48415,TX,"Scurry County, TX",6206,5694,512,8,6145,5741,404,6,6283,6023,260,4,16937,16830,16686,46,214,215,40,232,229,2087,3600,3573,1732
48417,TX,"Shackelford County, TX",1774,1680,94,5,1863,1788,75,4,1830,1780,50,2,3105,3177,3186,7,35,34,13,59,53,203,478,764,706
48419,TX,"Shelby County, TX",11205,10438,767,6,11534,10907,627,5,11029,10564,465,4,23927,23962,24008,82,308,320,93,357,361,3054,5595,4904,2241
48421,TX,"Sherman County, TX",1302,1262,40,3,1394,1351,43,3,1377,1338,39,2,2787,2791,2799,15,46,49,5,30,31,449,351,461,320
48423,TX,"Smith County, TX",108156,100798,7358,6,110700,104979,5721,5,112049,107882,4167,3,234195,237114,241922,712,2891,3030,616,3010,2914,18792,36697,53997,42515
48425,TX,"Somervell County, TX",4267,3987,280,6,4439,4209,230,5,4573,4399,174,3,9204,9472,9757,9,79,84,24,120,118,689,2104,1834,1816
48427,TX,"Starr County, TX",26077,21501,4576,17,25577,21581,3996,15,24554,21865,2689,11,65861,65972,65728,212,1071,1111,101,685,673,15041,9651,7299,4476
48429,TX,"Stephens County, TX",4019,3774,245,6,4212,4004,208,4,4073,3921,152,3,9098,9434,9390,29,94,102,28,155,152,946,2149,1989,1162
48431,TX,"Sterling County, TX",558,522,36,6,586,556,30,5,525,504,21,4,1381,1382,1417,4,25,22,3,15,15,61,375,218,151
48433,TX,"Stonewall County, TX",571,542,29,5,589,564,25,4,695,674,21,3,1245,1208,1182,1,9,9,5,29,29,124,306,251,117
48435,TX,"Sutton County, TX",1212,1092,120,9,1166,1071,95,8,1034,975,59,5,3355,3284,3217,7,36,35,11,52,53,495,730,509,411
48437,TX,"Swisher County, TX",2514,2383,131,5,2603,2472,131,5,2583,2479,104,4,6946,6996,6881,21,80,80,29,115,121,1258,1586,1038,757
48439,TX,"Tarrant County, TX",1076624,996842,79782,7,1109988,1051270,58718,5,1140773,1099642,41131,3,2115682,2129402,2154595,6339,26355,27473,3797,18074,17180,179770,318869,398379,449725
48441,TX,"Taylor County, TX",65960,62350,3610,5,67618,64641,2977,4,68871,66574,2297,3,143444,143942,145163,433,1869,1944,325,1831,1764,9231,25623,27702,24161
48443,TX,"Terrell County, TX",379,362,17,4,416,401,15,3,410,396,14,3,750,720,693,2,6,6,1,19,16,110,221,312,167
48445,TX,"Terry County, TX",4800,4448,352,7,4813,4523,290,6,4653,4460,193,4,11794,11721,11567,37,167,175,27,171,171,1993,2344,2172,865
48447,TX,"Throckmorton County, TX",637,606,31,4,987,958,29,2,738,715,23,3,1453,1508,1550,6,16,16,2,18,20,90,352,330,233
48449,TX,"Titus County, TX",13232,12339,893,6,13649,12911,738,5,13742,13149,593,4,31292,31266,31208,109,424,443,74,369,360,3987,7143,4779,3239
48451,TX,"Tom Green County, TX",53632,50224,3408,6,54900,52235,2665,4,55646,53740,1906,3,120194,119250,118892,364,1445,1511,269,1511,1468,9600,22547,25084,19176
48453,TX,"Travis County, TX",735013,688176,46837,6,778563,747009,31554,4,822494,799306,23188,2,1296515,1308544,1326436,3627,15073,15739,1748,7597,7245,82571,138636,195820,464623
48455,TX,"Trinity County, TX",5295,4864,431,8,5390,4997,393,7,5359,5078,281,5,13632,13809,13996,29,131,134,67,299,297,1603,3886,3138,1330
48457,TX,"Tyler County, TX",7341,6614,727,9,7408,6782,626,8,7167,6736,431,6,19811,19892,20030,32,197,204,66,373,372,2663,5639,3905,2113
48459,TX,"Upshur County, TX",17485,16136,1349,7,17658,16561,1097,6,17822,17063,759,4,41038,41811,42488,136,479,504,119,632,612,4030,9453,9596,4820
48461,TX,"Upton County, TX",1809,1706,103,5,1782,1690,92,5,2349,2286,63,2,3301,3241,3152,8,33,34,6,39,40,533,812,615,266
48463,TX,"Uvalde County, TX",11276,10550,726,6,11344,10717,627,5,11274,10781,493,4,24559,24810,24940,94,377,391,71,351,342,3876,4537,4123,2831
48465,TX,"Val Verde County, TX",21485,19690,1795,8,22282,20973,1309,5,22262,21262,1000,4,47605,47589,47606,190,743,774,104,555,540,8387,7410,7393,5641
48467,TX,"Van Zandt County, TX",26031,24427,1604,6,27003,25719,1284,4,27865,26897,968,3,59749,61200,62859,151,589,617,176,962,935,5674,13189,14814,7234
48469,TX,"Victoria County, TX",40843,37435,3408,8,41192,38600,2592,6,41365,39638,1727,4,91303,90897,91065,282,1168,1219,233,1109,1082,9766,18268,20097,11551
48471,TX,"Walker County, TX",24006,22278,1728,7,24081,22574,1507,6,23957,22834,1123,4,76544,78322,78870,155,633,652,160,705,687,7039,19393,13350,9984
48473,TX,"Waller County, TX",24400,22538,1862,7,24937,23356,1581,6,25450,24357,1093,4,57304,59474,61894,180,698,730,102,504,485,3895,9556,9887,7868
48475,TX,"Ward County, TX",6149,5565,584,9,5943,5531,412,6,6183,5956,227,3,11680,11111,10964,61,169,178,27,134,140,1516,2509,2323,775
48477,TX,"Washington County, TX",15193,14333,860,5,15344,14533,811,5,15256,14650,606,4,35805,35898,36159,76,353,373,133,519,499,2587,7633,6894,6675
48479,TX,"Webb County, TX",115889,106060,9829,8,116534,109245,7289,6,117364,112532,4832,4,267345,267633,267780,1020,4208,4376,381,2157,2079,46603,35298,38527,29041
48481,TX,"Wharton County, TX",21289,19840,1449,6,21238,20035,1203,5,21416,20602,814,3,41564,41697,41824,141,532,543,123,564,561,5219,7812,8780,4991
48483,TX,"Wheeler County, TX",2187,2054,133,6,2079,1951,128,6,1989,1911,78,3,4976,4905,4807,10,50,49,8,84,85,635,1154,1022,594
48485,TX,"Wichita County, TX",55392,51706,3686,6,55714,52752,2962,5,55458,53290,2168,3,129617,130006,129978,357,1528,1596,324,1813,1727,9873,27245,26660,19125
48487,TX,"Wilbarger County, TX",4898,4611,287,5,4938,4614,324,6,4832,4596,236,4,12844,12688,12491,36,146,158,47,217,217,1871,2893,2626,1337
48489,TX,"Willacy County, TX",6591,5800,791,12,7062,6347,715,10,7227,6636,591,8,20150,20290,20143,46,224,234,51,246,246,4085,4925,2728,1246
48491,TX,"Williamson County, TX",323314,304437,18877,5,344045,330223,13822,4,364532,353870,10662,2,615517,644451,671418,1625,7117,7458,924,4098,3933,23697,73860,120665,177127
48493,TX,"Wilson County, TX",24394,22994,1400,5,25202,24083,1119,4,25982,25135,847,3,50051,51281,52735,133,527,551,98,588,578,3579,11016,10903,8058
48495,TX,"Winkler County, TX",3965,3590,375,9,3756,3475,281,7,3977,3820,157,3,7750,7373,7306,17,105,112,15,90,93,1309,1399,1452,470
48497,TX,"Wise County, TX",32122,30016,2106,6,33297,31671,1626,4,34311,33106,1205,3,68943,71888,74895,195,801,835,173,841,811,6455,15481,15222,8551
48499,TX,"Wood County, TX",17832,16648,1184,6,18184,17155,1029,5,18256,17436,820,4,45041,46031,46857,92,375,388,165,879,848,4475,10398,10842,6603
48501,TX,"Yoakum County, TX",3505,3084,421,12,3303,3052,251,7,3286,3153,133,4,7675,7559,7451,27,130,134,17,93,97,1271,1390,1525,505
48503,TX,"Young County, TX",7732,7323,409,5,8125,7754,371,4,8083,7806,277,3,17847,17911,17962,42,202,219,73,352,338,1646,3914,3674,3190
48505,TX,"Zapata County, TX",4668,4096,572,12,4596,4060,536,11,4580,4263,317,6,13874,13893,13849,47,199,205,30,133,137,2502,2573,1865,939
48507,TX,"Zavala County, TX",3391,2906,485,14,3286,2878,408,12,3395,3104,291,8,9662,9487,9377,38,146,148,36,153,154,1437,1844,1733,869
49000,UT,Utah,1647376,1567777,79599,4,1687539,1641338,46201,2,1743054,1702674,40380,2,3283785,3339113,3380800,11862,45745,46912,4958,22016,23363,132503,435611,672887,680859
49001,UT,"Beaver County, UT",2850,2733,117,4,2843,2761,82,2,2869,2791,78,2,7087,7203,7327,23,91,94,10,68,74,377,1120,1483,1089
49003,UT,"Box Elder County, UT",26747,25551,1196,4,26993,26317,676,2,27662,27039,623,2,57946,59693,61498,226,804,821,129,499,533,2129,10863,12630,8283
49005,UT,"Cache County, UT",66154,64163,1991,3,69047,67652,1395,2,71311,69885,1426,2,133624,137429,140173,543,2068,2122,134,716,740,3922,13757,23294,26218
49007,UT,"Carbon County, UT",8636,8172,464,5,8456,8124,332,3,8459,8162,297,3,20488,20361,20571,62,230,234,55,276,282,1118,3827,5985,2187
49009,UT,"Daggett County, UT",413,394,19,4,412,397,15,3,418,399,19,4,952,977,1014,1,11,12,1,7,7,15,129,141,68
49011,UT,"Davis County, UT",176943,169478,7465,4,179847,175386,4461,2,184220,180239,3981,2,363745,367446,369948,1295,4847,4956,530,2328,2422,9115,44724,76993,80347
49013,UT,"Duchesne County, UT",7869,7241,628,8,7777,7400,377,4,8057,7800,257,3,19617,19806,20161,91,270,283,33,176,183,1186,4669,4051,1683
49015,UT,"Emery County, UT",4421,4207,214,4,4461,4286,175,3,4497,4349,148,3,9842,9963,10099,25,108,116,24,109,122,357,1947,2964,939
49017,UT,"Garfield County, UT",2665,2387,278,10,2790,2611,179,6,2936,2763,173,5,5107,5149,5281,21,61,61,11,59,64,170,1154,1315,887
49019,UT,"Grand County, UT",6269,5665,604,9,6624,6334,290,4,7006,6780,226,3,9677,9665,9769,24,100,103,20,88,87,440,2040,2677,1896
49021,UT,"Iron County, UT",25377,24203,1174,4,26538,25774,764,2,27805,27125,680,2,57708,60522,62429,226,781,803,88,428,442,2090,7539,12562,9156
49023,UT,"Juab County, UT",5868,5689,179,3,6172,6046,126,2,6415,6289,126,2,11818,12192,12567,45,199,205,13,86,91,490,2241,2439,1380
49025,UT,"Kane County, UT",3893,3681,212,5,4036,3918,118,2,4128,4025,103,2,7688,7999,8227,26,93,94,13,83,93,409,1421,2082,1687
49027,UT,"Millard County, UT",6052,5852,200,3,6064,5917,147,2,6252,6110,142,2,13049,13175,13330,53,187,192,23,146,151,803,2582,2597,1839
49029,UT,"Morgan County, UT",5686,5491,195,3,5800,5675,125,2,5949,5831,118,2,12381,12667,12832,32,144,145,17,73,79,147,1298,2655,2695
49031,UT,"Piute County, UT",483,453,30,6,484,463,21,4,516,495,21,4,1433,1482,1487,3,18,19,5,19,23,136,426,442,255
49033,UT,"Rich County, UT",1168,1127,41,3,1280,1251,29,2,1251,1220,31,2,2500,2581,2628,6,27,27,6,19,18,47,383,709,347
49035,UT,"Salt Lake County, UT",646307,612465,33842,5,656258,637796,18462,2,678205,662608,15597,2,1186921,1186440,1186257,3838,15035,15426,1826,7919,8435,61229,166397,241886,277237
49037,UT,"San Juan County, UT",5521,4944,577,10,5501,5158,343,6,5597,5352,245,4,14517,14476,14359,46,179,184,47,168,179,1188,2496,3332,1817
49039,UT,"Sanpete County, UT",12807,12314,493,3,13100,12724,376,2,13592,13220,372,2,28521,29138,29724,87,384,391,60,256,279,1544,5206,6453,3937
49041,UT,"Sevier County, UT",9939,9507,432,4,10023,9692,331,3,10288,9996,292,2,21561,21918,22069,71,276,286,49,227,241,1034,4366,5184,2950
49043,UT,"Summit County, UT",24731,22907,1824,7,25054,24324,730,2,26233,25670,563,2,42482,43168,43036,109,409,415,48,183,200,1413,4571,6777,15704
49045,UT,"Tooele County, UT",36206,34460,1746,4,36943,35866,1077,2,38233,37266,967,2,73338,76734,79934,268,1036,1061,101,473,507,3187,13159,15830,9620
49047,UT,"Uintah County, UT",13535,12251,1284,9,13534,12785,749,5,14112,13606,506,3,35671,36232,37141,144,511,522,63,309,337,2600,7385,7327,3623
49049,UT,"Utah County, UT",317902,305575,12327,3,332754,324841,7913,2,345265,337880,7385,2,663559,685806,702434,3049,11725,12030,697,3156,3368,15883,54886,117261,137780
49051,UT,"Wasatch County, UT",16537,15447,1090,6,17021,16529,492,2,17806,17394,412,2,35063,36260,36619,97,388,398,40,190,195,811,4128,6531,9103
49053,UT,"Washington County, UT",80398,75986,4412,5,84076,81594,2482,3,87269,85075,2194,2,182009,191476,197680,533,2222,2280,419,1802,1936,7278,25231,47687,35197
49055,UT,"Wayne County, UT",1454,1342,112,7,1486,1415,71,4,1519,1452,67,4,2508,2567,2645,12,38,39,6,36,35,147,440,796,385
49057,UT,"Weber County, UT",130550,124095,6455,4,132170,128305,3865,2,135182,131853,3329,2,262973,266588,269561,906,3503,3593,490,2117,2240,13238,47226,58804,42550
50000,VT,Vermont,339810,320542,19268,5,335823,323354,12469,3,342119,333081,9038,2,642893,646972,647064,1303,5069,5342,1565,6429,7148,27915,127128,113730,185690
50001,VT,"Addison County, VT",20443,19498,945,4,20413,19804,609,3,20868,20362,506,2,37343,37444,37578,79,279,292,77,329,379,1475,7605,5925,10981
50003,VT,"Bennington County, VT",17635,16468,1167,6,17320,16512,808,4,17636,17072,564,3,37300,37424,37392,76,277,290,113,501,544,1593,7289,7464,10233
50005,VT,"Caledonia County, VT",14509,13635,874,6,14347,13770,577,4,14641,14184,457,3,30183,30423,30579,46,240,251,84,350,387,1555,7437,6062,6722
50007,VT,"Chittenden County, VT",95851,91279,4572,4,95121,92206,2915,3,97153,95148,2005,2,168386,169271,169301,349,1312,1393,328,1237,1390,5544,19982,25487,60163
50009,VT,"Essex County, VT",2702,2495,207,7,2672,2532,140,5,2679,2573,106,4,5918,5965,5994,16,57,58,22,81,89,467,2027,1156,907
50011,VT,"Franklin County, VT",27268,25858,1410,5,27361,26343,1018,3,27723,26994,729,2,50040,50433,50731,141,508,532,105,457,504,2892,13022,9444,9526
50013,VT,"Grand Isle County, VT",4069,3830,239,5,4036,3868,168,4,4127,3992,135,3,7276,7418,7489,16,60,62,22,78,90,284,1640,1231,2323
50015,VT,"Lamoille County, VT",13859,12779,1080,7,13728,13134,594,4,14058,13587,471,3,25917,26147,26090,57,222,237,55,233,263,1209,4519,4762,7745
50017,VT,"Orange County, VT",15820,14983,837,5,15544,15000,544,3,15762,15356,406,2,29299,29625,29846,50,219,233,67,286,311,1388,7347,5489,7401
50019,VT,"Orleans County, VT",13050,12049,1001,7,13042,12388,654,5,13347,12760,587,4,27404,27601,27666,64,251,261,72,370,413,1757,7487,5306,5460
50021,VT,"Rutland County, VT",30201,28142,2059,6,29597,28260,1337,4,29836,28860,976,3,60477,60720,60366,114,479,507,189,760,856,2780,14999,12327,14213
50023,VT,"Washington County, VT",33871,32201,1670,4,33129,32048,1081,3,33906,33079,827,2,59756,60023,60048,111,445,467,161,612,677,2301,11185,10408,18765
50025,VT,"Windham County, VT",21616,20143,1473,6,20874,19876,998,4,21221,20608,613,2,45850,46128,45842,68,284,295,113,486,532,2149,10352,7608,13888
50027,VT,"Windsor County, VT",28918,27183,1735,6,28638,27611,1027,3,29164,28510,654,2,57744,58350,58142,116,436,464,157,649,713,2521,12237,11061,17363
51000,VA,Virginia,4342950,4062417,280533,6,4331297,4162555,168742,3,4435858,4308805,127053,2,8636471,8657365,8683619,23580,94523,96748,19817,83281,83823,539599,1402487,1568038,2372397
51001,VA,"Accomack County, VA",15933,14858,1075,6,15396,14729,667,4,15741,15226,515,3,33388,33364,33191,89,330,337,129,530,532,4331,8485,6487,5133
51003,VA,"Albemarle County, VA",56131,53011,3120,5,56427,54591,1836,3,58180,56633,1547,2,112502,113742,114534,202,971,992,236,1053,1073,5069,11146,14960,44704
51005,VA,"Alleghany County, VA",6770,6311,459,6,6577,6306,271,4,6693,6474,219,3,15186,15024,14835,43,118,121,62,278,275,1201,4726,3583,1718
51007,VA,"Amelia County, VA",6094,5727,367,6,6094,5877,217,3,6294,6109,185,2,13268,13337,13455,42,151,152,41,197,198,1395,4213,2286,1697
51009,VA,"Amherst County, VA",14672,13824,848,5,14569,14031,538,3,14844,14384,460,3,31309,31391,31589,61,294,304,94,406,400,2798,8678,6251,4946
51011,VA,"Appomattox County, VA",7077,6655,422,6,7025,6753,272,3,7147,6918,229,3,16154,16398,16748,42,203,208,41,186,182,1261,4362,3516,2214
51013,VA,"Arlington County, VA",151524,144538,6986,4,152740,148157,4583,3,157061,153800,3261,2,238799,233574,234000,699,2642,2695,360,1195,1202,8860,12874,19373,132370
51015,VA,"Augusta County, VA",36927,35165,1762,4,36931,35792,1139,3,38206,37214,992,2,77567,77778,78064,110,490,503,211,865,866,5976,23102,14752,12778
51017,VA,"Bath County, VA",2300,2063,237,10,2253,2153,100,4,2480,2419,61,2,4186,4087,4049,9,42,42,19,84,86,495,1260,958,621
51019,VA,"Bedford County, VA",37973,35970,2003,5,37852,36550,1302,3,38542,37438,1104,2,79553,80287,80848,147,626,642,218,994,1004,4409,17112,18169,17802
51021,VA,"Bland County, VA",2794,2630,164,5,2751,2656,95,3,2803,2722,81,2,6257,6179,6148,7,42,42,21,100,99,547,2227,1499,658
51023,VA,"Botetourt County, VA",17206,16401,805,4,17235,16710,525,3,17685,17234,451,2,33637,33977,34135,60,232,235,92,412,405,1531,8651,7785,6773
51025,VA,"Brunswick County, VA",5921,5434,487,8,5777,5420,357,6,5887,5619,268,4,15824,15979,15921,31,143,149,52,237,235,2561,4238,3151,1911
51027,VA,"Buchanan County, VA",6400,5771,629,9,6168,5758,410,6,6354,6053,301,4,20249,19861,19352,46,156,158,79,388,403,4090,5991,3717,1766
51029,VA,"Buckingham County, VA",6292,5812,480,7,6308,5982,326,5,6452,6198,254,3,16826,16940,16982,27,130,131,55,223,220,2419,5746,2970,1483
51031,VA,"Campbell County, VA",25602,24051,1551,6,25393,24421,972,3,25843,25039,804,3,55625,55375,55141,101,363,377,167,709,713,4239,13623,12619,9634
51033,VA,"Caroline County, VA",14944,13903,1041,7,14911,14272,639,4,15392,14892,500,3,30924,31402,31957,90,342,350,83,359,352,2394,8134,5950,4643
51035,VA,"Carroll County, VA",13129,12013,1116,8,12805,12274,531,4,12931,12475,456,3,29142,29071,29147,61,232,239,121,494,496,4036,8205,6318,3322
51036,VA,"Charles City County, VA",3513,3271,242,6,3505,3353,152,4,3606,3494,112,3,6744,6631,6605,19,39,41,26,105,108,916,2132,1472,834
51037,VA,"Charlotte County, VA",5083,4789,294,5,5270,5073,197,3,5596,5428,168,3,11541,11522,11475,46,153,153,44,202,200,1265,3024,2633,1234
51041,VA,"Chesterfield County, VA",187222,175853,11369,6,187364,180538,6826,3,193994,188569,5425,2,365776,371276,378408,984,3837,3927,783,3161,3200,18029,55077,69227,100368
51043,VA,"Clarke County, VA",7429,7076,353,4,7486,7252,234,3,7687,7491,196,2,14813,14916,15266,36,127,131,33,201,200,895,3104,2969,3787
51045,VA,"Craig County, VA",2258,2138,120,5,2256,2181,75,3,2315,2245,70,3,4878,4876,4847,7,44,44,21,76,72,400,1324,1063,729
51047,VA,"Culpeper County, VA",24715,23451,1264,5,24880,24067,813,3,25586,24872,714,2,52766,53785,54381,173,652,664,127,469,463,3895,11432,10395,9291
51049,VA,"Cumberland County, VA",4576,4288,288,6,4607,4410,197,4,4794,4633,161,3,9666,9696,9746,19,75,75,31,124,121,865,2698,2411,1254
51051,VA,"Dickenson County, VA",4723,4334,389,8,4669,4421,248,5,4555,4355,200,4,14074,13852,13725,26,118,119,51,244,242,2112,4245,3093,1097
51053,VA,"Dinwiddie County, VA",13392,12507,885,6,13452,12850,602,4,13820,13369,451,3,27888,27999,28161,37,198,204,88,338,337,2246,7719,6419,3493
51057,VA,"Essex County, VA",5457,5065,392,7,5430,5173,257,4,5507,5318,189,3,10595,10552,10630,23,114,119,36,177,174,1178,2875,2407,1218
51059,VA,"Fairfax County, VA",624147,586488,37659,6,623248,601506,21742,3,639598,623827,15771,2,1148558,1141645,1138331,3141,12488,12771,1856,6528,6565,51874,96148,137108,496667
51061,VA,"Fauquier County, VA",36535,34755,1780,4,36720,35614,1106,3,37804,36837,967,2,72990,74022,74664,190,712,728,161,637,639,3579,12804,14759,18841
51063,VA,"Floyd County, VA",8092,7669,423,5,8246,7987,259,3,8485,8272,213,2,15469,15509,15619,36,143,145,49,244,247,1139,4469,3556,2458
51065,VA,"Fluvanna County, VA",13718,12970,748,5,13812,13361,451,3,14238,13873,365,2,27285,27797,28159,63,258,263,65,266,265,1301,4623,6805,7244
51067,VA,"Franklin County, VA",25984,24518,1466,5,25924,24999,925,3,26517,25735,782,2,54486,55010,55074,119,471,482,170,743,757,4338,13639,12932,9006
51069,VA,"Frederick County, VA",49136,46783,2353,4,49819,48360,1459,2,51483,50233,1250,2,91865,94014,95051,245,980,1004,196,929,943,7295,19835,18210,17287
51071,VA,"Giles County, VA",7743,7242,501,6,7827,7555,272,3,8121,7866,255,3,16785,16584,16453,35,168,171,65,312,315,1231,4678,4028,2262
51073,VA,"Gloucester County, VA",19181,18100,1081,5,19188,18539,649,3,19534,19003,531,2,38718,39131,39493,83,345,360,115,518,502,2982,8119,9984,7136
51075,VA,"Goochland County, VA",11351,10786,565,5,11440,11088,352,3,11858,11535,323,2,24853,25499,26109,35,158,159,55,261,256,1098,3961,4822,8441
51077,VA,"Grayson County, VA",7974,7499,475,6,7768,7504,264,3,8048,7836,212,2,15278,15330,15343,17,110,113,74,261,264,2020,4374,3440,1818
51079,VA,"Greene County, VA",10296,9740,556,5,10344,10034,310,3,10661,10404,257,2,20606,21028,21107,48,247,251,47,192,190,1640,4265,4175,4035
51081,VA,"Greensville County, VA",4235,3941,294,6,4303,4094,209,4,4352,4187,165,3,11382,11412,11226,30,109,109,46,167,168,2010,3591,2250,963
51083,VA,"Halifax County, VA",15091,13991,1100,7,15019,14305,714,4,15409,14812,597,3,33920,33758,33644,85,353,364,138,608,619,4270,9024,7385,4044
51085,VA,"Hanover County, VA",57676,54782,2894,5,57957,56232,1725,3,60172,58700,1472,2,110195,111821,112938,264,966,986,272,1166,1184,4694,19113,21294,30755
51087,VA,"Henrico County, VA",180336,168231,12105,6,179815,172692,7123,4,185715,180462,5253,2,334344,333867,333962,886,3649,3736,873,3620,3703,16841,50538,59894,103917
51089,VA,"Henry County, VA",23636,21768,1868,7,23624,22519,1105,4,23815,22997,818,3,50846,50296,49906,92,348,352,189,904,905,7162,12836,11768,5671
51091,VA,"Highland County, VA",1225,1177,48,3,1241,1205,36,2,1399,1367,32,2,2241,2241,2301,7,17,17,10,29,29,133,686,395,474
51093,VA,"Isle of Wight County, VA",19268,18259,1009,5,19379,18706,673,3,19716,19164,552,2,38702,39393,40151,84,360,370,91,444,442,2483,8090,8893,8003
51095,VA,"James City County, VA",36839,34213,2626,7,36503,35061,1442,4,37036,35960,1076,2,78478,79914,81199,220,743,766,205,954,965,2490,10888,14524,28443
51097,VA,"King and Queen County, VA",3853,3650,203,5,3847,3725,122,3,3947,3843,104,2,6588,6668,6718,11,58,58,24,112,112,615,1988,1522,1115
51099,VA,"King George County, VA",13789,13148,641,4,14028,13617,411,2,14416,14045,371,2,26822,27522,27856,79,308,314,57,237,234,1361,5015,5114,6161
51101,VA,"King William County, VA",9238,8728,510,5,9282,8972,310,3,9589,9334,255,2,17916,18205,18492,51,200,207,54,196,196,896,4002,4170,3010
51103,VA,"Lancaster County, VA",5331,4928,403,7,5273,4992,281,5,5418,5224,194,3,10897,10896,10750,8,59,60,61,255,253,877,2699,2215,2897
51105,VA,"Lee County, VA",8252,7704,548,6,8088,7756,332,4,8222,7911,311,3,22107,22061,21982,55,214,221,78,386,390,3428,5998,5712,1831
51107,VA,"Loudoun County, VA",225807,213383,12424,5,225653,218649,7004,3,232532,226976,5556,2,422669,428435,432085,1183,4699,4810,515,1930,1950,15832,30890,52054,168028
51109,VA,"Louisa County, VA",19884,18809,1075,5,20142,19459,683,3,20876,20309,567,2,37798,39032,40116,105,408,415,97,417,411,2940,9540,7645,7006
51111,VA,"Lunenburg County, VA",5221,4936,285,5,5111,4915,196,3,5198,5019,179,3,11947,11997,12031,34,122,122,44,179,174,1764,3413,2502,1023
51113,VA,"Madison County, VA",7286,6998,288,4,7401,7215,186,2,7586,7417,169,2,13860,13950,14000,21,125,131,33,160,161,1236,3537,2761,2467
51115,VA,"Mathews County, VA",3993,3788,205,5,4009,3882,127,3,4096,3979,117,2,8520,8545,8490,13,56,56,44,147,143,474,1869,2170,1924
51117,VA,"Mecklenburg County, VA",12601,11715,886,7,12566,11970,596,4,13107,12637,470,3,30278,30300,30508,66,267,272,142,533,532,3048,7779,6661,5033
51119,VA,"Middlesex County, VA",5122,4851,271,5,5144,4969,175,3,5315,5169,146,2,10616,10772,10943,12,83,83,45,197,200,1017,2470,2662,2289
51121,VA,"Montgomery County, VA",48776,46362,2414,4,49876,48372,1504,3,51961,50525,1436,2,99561,98835,98915,182,673,690,168,747,769,3294,13305,14055,26007
51125,VA,"Nelson County, VA",7186,6764,422,5,7232,6977,255,3,7396,7191,205,2,14737,14800,14652,33,134,135,51,228,231,1729,3672,2373,3377
51127,VA,"New Kent County, VA",12682,12085,597,4,12790,12410,380,3,13258,12941,317,2,23119,23979,24986,56,230,241,45,216,213,1107,4926,5042,5397
51131,VA,"Northampton County, VA",5391,4956,435,8,5432,5147,285,5,5536,5342,194,3,12208,12039,11900,22,101,100,79,238,236,1285,2874,2379,2553
51133,VA,"Northumberland County, VA",5631,5258,373,6,5547,5278,269,4,5584,5362,222,4,11838,12046,12302,16,79,79,50,220,217,893,2696,2567,3151
51135,VA,"Nottoway County, VA",7157,6781,376,5,7119,6857,262,3,7245,7023,222,3,15639,15584,15559,38,151,152,49,239,238,1879,4335,3223,1841
51137,VA,"Orange County, VA",17042,16047,995,5,17180,16553,627,3,17595,17071,524,3,36391,37189,37991,103,392,404,91,469,470,2659,9322,6947,6692
51139,VA,"Page County, VA",11957,11048,909,7,12020,11464,556,4,12215,11801,414,3,23687,23801,23750,54,228,234,100,378,378,2949,7928,3954,2537
51141,VA,"Patrick County, VA",7194,6684,510,7,7142,6823,319,4,7166,6909,257,3,17583,17668,17643,33,131,134,60,318,320,2280,4835,4234,2226
51143,VA,"Pittsylvania County, VA",29796,27807,1989,6,29678,28488,1190,4,30176,29229,947,3,60365,60090,59952,115,464,474,191,859,873,7194,17025,14471,6426
51145,VA,"Powhatan County, VA",14080,13375,705,5,14153,13742,411,2,14698,14325,373,2,30438,31172,31489,53,250,256,70,300,300,1950,6749,6860,7013
51147,VA,"Prince Edward County, VA",10086,9412,674,6,10017,9531,486,4,9978,9584,394,3,21898,21957,21927,74,237,243,68,290,286,1798,4315,3309,3140
51149,VA,"Prince George County, VA",14895,13895,1000,6,14931,14258,673,4,15425,14897,528,3,43045,42998,43134,81,367,378,68,300,298,3287,8799,9957,7115
51153,VA,"Prince William County, VA",246236,229633,16603,6,245005,235333,9672,3,251206,244349,6857,2,482790,485205,486943,1530,6169,6318,736,2754,2770,31771,61443,82131,130903
51155,VA,"Pulaski County, VA",16123,14810,1313,8,16099,15460,639,4,16647,16132,515,3,33804,33808,33706,76,293,301,116,560,560,2696,8548,9227,5006
51157,VA,"Rappahannock County, VA",3602,3431,171,4,3636,3529,107,2,3719,3625,94,2,7321,7437,7502,11,47,49,19,80,78,464,1799,1566,1788
51159,VA,"Richmond County, VA",4014,3811,203,5,3973,3833,140,3,3995,3880,115,2,8919,9049,9080,17,91,90,31,136,134,1525,2228,1921,1201
51161,VA,"Roanoke County, VA",48770,46198,2572,5,48627,47089,1538,3,49877,48598,1279,2,96922,96751,96914,163,713,731,275,1203,1237,4521,18838,20220,26045
51163,VA,"Rockbridge County, VA",10373,9781,592,5,10523,10132,391,3,10827,10516,311,2,22645,22639,22593,33,115,117,64,338,340,1838,6033,4338,4790
51165,VA,"Rockingham County, VA",41503,39479,2024,4,41987,40739,1248,3,42950,41852,1098,2,83765,84470,85397,210,835,856,249,937,949,7881,20893,12528,15810
51167,VA,"Russell County, VA",11128,10361,767,6,10772,10302,470,4,10921,10531,390,3,25756,25577,25448,43,219,223,83,411,418,3510,7394,5993,2342
51169,VA,"Scott County, VA",8946,8448,498,5,8909,8587,322,3,9222,8926,296,3,21585,21482,21476,39,170,172,67,403,401,2896,5885,5046,2260
51171,VA,"Shenandoah County, VA",22035,20827,1208,5,21842,21057,785,3,22075,21455,620,2,44263,44829,44968,130,513,529,167,648,657,3474,12723,8915,6437
51173,VA,"Smyth County, VA",13347,12453,894,6,13568,13002,566,4,13569,13138,431,3,29782,29600,29449,58,269,275,114,556,559,3476,8618,6346,3503
51175,VA,"Southampton County, VA",9037,8575,462,5,8850,8541,309,3,8884,8634,250,2,17952,18037,17932,29,105,105,57,236,238,1941,4224,4642,2582
51177,VA,"Spotsylvania County, VA",67617,63432,4185,6,67579,65012,2567,3,69507,67457,2050,2,140594,143957,146688,374,1527,1566,300,1184,1194,7807,25127,28770,31018
51179,VA,"Stafford County, VA",73380,69118,4262,5,73479,70794,2685,3,75743,73567,2176,2,157746,161584,163380,451,1772,1822,214,942,924,6724,21840,28535,41874
51181,VA,"Surry County, VA",3582,3369,213,5,3565,3430,135,3,3610,3503,107,3,6551,6524,6527,19,62,62,27,93,89,724,1589,1517,1120
51183,VA,"Sussex County, VA",3672,3344,328,8,3653,3421,232,6,3699,3542,157,4,10789,10812,10680,25,98,99,45,159,154,1640,3278,2142,1073
51185,VA,"Tazewell County, VA",15427,14203,1224,7,15126,14328,798,5,15381,14730,651,4,40405,40057,39821,97,342,353,154,724,740,4478,11030,9209,4795
51187,VA,"Warren County, VA",20221,18999,1222,6,20211,19490,721,3,20781,20185,596,2,40786,40957,41440,111,441,453,95,462,463,3286,9632,8896,6326
51191,VA,"Washington County, VA",25815,24262,1553,6,25578,24659,919,3,26424,25653,771,2,53889,53793,53958,114,483,493,177,846,870,4858,13818,11552,9889
51193,VA,"Westmoreland County, VA",9470,8895,575,6,9609,9185,424,4,9596,9292,304,3,18508,18732,18712,39,172,178,63,291,286,2284,5457,3713,2269
51195,VA,"Wise County, VA",13054,12032,1022,7,12744,12075,669,5,12808,12279,529,4,36061,35707,35421,84,334,343,125,604,617,5722,8859,7795,3827
51197,VA,"Wythe County, VA",13785,12680,1105,8,13639,13086,553,4,14127,13695,432,3,28312,28200,28111,77,253,262,92,486,494,2322,7726,6698,4085
51199,VA,"York County, VA",32597,30724,1873,5,32540,31462,1078,3,33233,32313,920,2,70228,71176,71341,154,605,626,124,555,547,2245,8345,13688,22898
51510,VA,"Alexandria city, VA",98782,92614,6168,6,98648,94940,3708,3,100923,98539,2384,2,159125,155203,155525,610,2380,2433,249,858,840,8213,12509,21018,78147
51520,VA,"Bristol city, VA",7517,6928,589,7,7405,7056,349,4,7587,7329,258,3,17295,17095,16975,53,174,173,63,307,305,1625,3797,3990,2880
51530,VA,"Buena Vista city, VA",3181,2997,184,5,2992,2874,118,3,3087,2992,95,3,6621,6615,6591,20,91,92,21,104,103,825,1398,1073,798
51540,VA,"Charlottesville city, VA",25133,23437,1696,6,25037,24122,915,3,25767,25093,674,2,46465,45730,45373,133,554,566,69,317,320,2291,4769,5580,17437
51550,VA,"Chesapeake city, VA",122286,114549,7737,6,121943,117268,4675,3,124126,120472,3654,2,249803,251739,252488,684,2814,2878,531,2260,2289,10807,39115,57351,59004
51570,VA,"Colonial Heights city, VA",8336,7716,620,7,8316,7922,394,4,8551,8275,276,3,18187,18218,18294,67,258,265,81,290,288,1072,4130,4226,3303
51580,VA,"Covington city, VA",2403,2163,240,10,2297,2164,133,5,2303,2208,95,4,5742,5731,5679,18,91,91,21,106,106,449,1931,1133,563
51590,VA,"Danville city, VA",19160,17236,1924,10,18632,17447,1185,6,18713,17844,869,4,42577,42376,42229,132,463,475,170,800,807,4682,10937,8617,5358
51595,VA,"Emporia city, VA",2339,2072,267,11,2356,2175,181,7,2340,2230,110,4,5709,5622,5481,16,58,58,38,125,124,972,1320,1067,473
51600,VA,"Fairfax city, VA",12618,11859,759,6,12596,12165,431,3,12929,12613,316,2,24175,24391,24835,157,611,624,64,262,262,1176,2210,2931,10038
51610,VA,"Falls Church city, VA",8207,7882,325,4,8308,8086,222,2,8573,8384,189,2,14677,14546,14586,53,174,177,34,106,104,262,639,1178,7681
51620,VA,"Franklin city, VA",3629,3314,315,8,3521,3286,235,6,3456,3315,141,4,8149,8128,8247,22,141,142,40,171,168,937,1709,1909,1214
51630,VA,"Fredericksburg city, VA",14100,13060,1040,7,14035,13382,653,4,14388,13904,484,3,27995,28458,28757,73,375,388,69,239,236,1511,3546,4628,7211
51640,VA,"Galax city, VA",2868,2638,230,8,2823,2705,118,4,2852,2763,89,3,6714,6659,6730,25,108,113,32,150,149,972,1197,1572,814
51650,VA,"Hampton city, VA",64671,58980,5691,8,63928,60381,3547,5,64520,62037,2483,3,137276,137847,138037,377,1574,1619,308,1498,1517,6817,26702,33103,25036
51660,VA,"Harrisonburg city, VA",24232,22621,1611,6,24355,23361,994,4,24936,24076,860,3,51706,51526,51158,181,630,649,104,362,354,4416,7029,5931,9172
51670,VA,"Hopewell city, VA",9687,8601,1086,11,9512,8823,689,7,9655,9229,426,4,23010,23145,22962,88,319,322,67,349,347,2239,5905,5265,1726
51678,VA,"Lexington city, VA",2032,1885,147,7,2090,1986,104,5,2222,2130,92,4,7321,7433,7457,24,100,102,22,90,87,113,646,500,1929
51680,VA,"Lynchburg city, VA",35666,32975,2691,7,35240,33459,1781,5,35743,34346,1397,3,78973,79118,79287,303,1184,1206,201,955,958,4500,10521,12279,16930
51683,VA,"Manassas city, VA",21381,19927,1454,6,21263,20432,831,3,21774,21203,571,2,42692,42765,42642,160,684,711,98,302,299,3920,7710,7165,8889
51685,VA,"Manassas Park city, VA",9661,8992,669,6,9590,9227,363,3,9810,9562,248,2,17161,17082,16703,9,33,34,10,41,41,2286,3162,2875,2865
51690,VA,"Martinsville city, VA",5627,4990,637,11,5557,5149,408,7,5552,5297,255,4,13479,13549,13725,57,247,258,57,310,308,1040,2729,3169,1971
51700,VA,"Newport News city, VA",89148,81125,8023,9,87840,83045,4795,5,88569,85347,3222,3,186033,184764,184306,653,2664,2727,414,1962,1981,10139,34662,41555,33786
51710,VA,"Norfolk city, VA",111223,101190,10033,9,109711,103587,6124,5,110356,106458,3898,3,237738,235025,232995,799,3131,3206,534,2299,2328,16695,36088,49426,47663
51720,VA,"Norton city, VA",1652,1525,127,7,1609,1529,80,5,1598,1538,60,3,3680,3631,3609,9,37,38,23,77,75,300,874,909,583
51730,VA,"Petersburg city, VA",13043,11124,1919,14,12709,11418,1291,10,12646,11933,713,5,33388,33367,33394,140,679,693,160,639,642,3486,7877,6580,5072
51735,VA,"Poquoson city, VA",6199,5929,270,4,6246,6071,175,2,6379,6222,157,2,12472,12609,12582,28,113,116,29,144,145,386,2204,2567,3570
51740,VA,"Portsmouth city, VA",44758,40364,4394,9,44192,41329,2863,6,44170,42462,1708,3,97954,97638,97029,293,1325,1353,307,1300,1316,6402,20822,24626,13766
51750,VA,"Radford city, VA",8496,7941,555,6,8639,8283,356,4,8987,8668,319,3,16119,16542,16738,41,158,161,19,136,137,581,1492,2378,3022
51760,VA,"Richmond city, VA",119939,109002,10937,9,118245,111931,6314,5,120998,116881,4117,3,227008,227602,229395,765,2973,3049,471,2108,2100,19617,32708,38715,68920
51770,VA,"Roanoke city, VA",49070,45160,3910,8,48354,46035,2319,4,49077,47513,1564,3,99883,98744,97847,333,1373,1408,359,1533,1567,8202,23913,19083,18751
51775,VA,"Salem city, VA",12668,11907,761,6,12579,12129,450,3,12905,12531,374,2,25399,25354,25523,84,275,284,97,445,452,1165,4744,5730,5516
51790,VA,"Staunton city, VA",12180,11384,796,6,12049,11588,461,3,12420,12080,340,2,25811,25653,25904,87,348,360,95,425,422,1522,5904,5277,5528
51800,VA,"Suffolk city, VA",45083,42082,3001,6,45037,43069,1968,4,45681,44255,1426,3,94697,96328,98537,256,1158,1185,266,998,1000,5829,16781,21157,19653
51810,VA,"Virginia Beach city, VA",229506,214678,14828,6,228327,219893,8434,3,232263,225770,6493,2,459646,458680,455618,1360,5329,5443,861,3745,3804,17439,65299,110200,121382
51820,VA,"Waynesboro city, VA",10589,9863,726,6,10471,10038,433,4,10795,10472,323,3,22276,22596,22808,77,337,340,61,283,284,1918,5511,3772,4342
51830,VA,"Williamsburg city, VA",6797,6223,574,8,6699,6375,324,4,6824,6545,279,4,15468,15675,15909,14,62,64,24,96,97,529,1613,1804,4016
51840,VA,"Winchester city, VA",14599,13699,900,6,14670,14155,515,3,15098,14687,411,2,28009,28115,27936,80,345,352,72,340,341,2396,4992,5097,6345
53000,WA,Washington,3936084,3603370,332714,8,3898707,3695705,203002,5,3990343,3822319,168024,4,7724031,7740745,7785786,21104,82466,84270,15165,64959,70778,426501,1150293,1733850,1968008
53001,WA,"Adams County, WA",9434,8762,672,7,9836,9298,538,5,9947,9436,511,5,20608,20640,20961,83,347,356,29,130,146,3489,3397,2668,1519
53003,WA,"Asotin County, WA",10502,9966,536,5,10552,10147,405,3,10654,10235,419,3,22325,22468,22508,53,213,220,69,294,316,1364,4527,6405,3816
53005,WA,"Benton County, WA",103942,95516,8426,8,104008,98090,5918,5,106236,100878,5358,5,207413,210585,212791,638,2489,2544,442,1805,1958,12876,30781,46488,42672
53007,WA,"Chelan County, WA",44640,40958,3682,8,44341,41948,2393,5,44776,42616,2160,4,79228,79775,79926,206,792,812,178,780,848,8199,13235,16927,15335
53009,WA,"Clallam County, WA",29351,26381,2970,10,29029,27107,1922,6,29022,27276,1746,6,77357,78442,77805,168,604,621,258,1153,1261,4206,14746,22389,17733
53011,WA,"Clark County, WA",247678,226978,20700,8,243695,230205,13490,5,249056,237315,11741,4,505301,512588,516779,1354,5425,5548,1041,4310,4774,23678,84308,122336,108188
53013,WA,"Columbia County, WA",1744,1618,126,7,1750,1654,96,5,1776,1679,97,5,3949,4015,4026,4,32,31,14,62,72,273,614,1343,817
53015,WA,"Cowlitz County, WA",48972,44466,4506,9,48156,45062,3094,6,48987,46205,2782,5,111019,111648,111956,296,1211,1229,297,1467,1576,7667,23635,31914,12960
53017,WA,"Douglas County, WA",21510,19712,1798,8,21407,20189,1218,5,21963,20798,1165,5,43031,43838,44192,139,483,488,82,357,387,5045,8301,8843,5967
53019,WA,"Ferry County, WA",2469,2187,282,11,2321,2113,208,9,2273,2054,219,9,7196,7267,7448,14,68,67,22,122,127,538,1838,2128,983
53021,WA,"Franklin County, WA",43327,39497,3830,8,43180,40292,2888,6,44261,41534,2727,6,97143,98126,98678,377,1454,1482,134,519,564,13299,13941,17073,10937
53023,WA,"Garfield County, WA",828,759,69,8,806,757,49,6,801,745,56,7,2298,2354,2363,5,21,23,2,26,33,100,394,747,423
53025,WA,"Grant County, WA",47795,43627,4168,8,46834,43693,3141,6,49103,46143,2960,6,99427,100440,101311,360,1370,1404,181,842,928,11830,16807,20439,10828
53027,WA,"Grays Harbor County, WA",29175,25776,3399,11,28778,26535,2243,7,29198,27237,1961,6,75855,76787,77038,171,677,692,251,1060,1133,5376,19067,21077,8877
53029,WA,"Island County, WA",36606,33616,2990,8,36230,34162,2068,5,36831,35010,1821,4,86990,87557,86625,182,767,788,196,874,944,2842,13698,24170,21894
53031,WA,"Jefferson County, WA",13109,11879,1230,9,12717,11918,799,6,12682,11978,704,5,33063,33561,33589,30,147,150,95,431,452,1057,5832,8799,11695
53033,WA,"King County, WA",1284350,1184981,99369,7,1279701,1226727,52974,4,1319911,1281609,38302,2,2274094,2253038,2266789,5984,23214,23762,3559,14514,15857,101861,238797,398938,869147
53035,WA,"Kitsap County, WA",130046,120108,9938,7,127157,120604,6553,5,129146,123313,5833,4,275802,276591,277673,664,2730,2792,556,2434,2702,9181,40579,74722,67073
53037,WA,"Kittitas County, WA",22648,20640,2008,8,21726,20332,1394,6,22514,21199,1315,5,44626,44688,45189,91,379,383,74,366,390,2073,6832,8691,9610
53039,WA,"Klickitat County, WA",9901,9099,802,8,9892,9275,617,6,9832,9259,573,5,22816,23178,23271,57,194,197,49,254,273,1582,4497,5486,5221
53041,WA,"Lewis County, WA",35187,31912,3275,9,34467,32262,2205,6,34855,32755,2100,6,82556,84575,85370,224,890,908,230,1048,1162,6188,17339,23135,10964
53043,WA,"Lincoln County, WA",4721,4406,315,6,4629,4395,234,5,4645,4395,250,5,10927,11277,11601,31,102,100,28,135,147,593,2104,3128,1871
53045,WA,"Mason County, WA",25664,23147,2517,9,25102,23347,1755,7,25346,23741,1605,6,66029,67229,68166,156,632,643,190,810,874,4556,14632,19405,8892
53047,WA,"Okanogan County, WA",19792,18048,1744,8,19350,18053,1297,6,19593,18337,1256,6,42146,42741,43127,93,421,435,98,505,569,4452,8535,10322,6266
53049,WA,"Pacific County, WA",8423,7506,917,10,8478,7807,671,7,8762,8164,598,6,23491,23971,24113,47,164,169,78,380,396,1747,5286,6992,4041
53051,WA,"Pend Oreille County, WA",5090,4564,526,10,5104,4713,391,7,5163,4806,357,6,13506,13906,14179,26,119,122,41,207,217,700,3103,3748,2148
53053,WA,"Pierce County, WA",455770,412397,43373,9,445825,418632,27193,6,453584,430230,23354,5,923524,927199,927380,2793,10923,11185,1768,7818,8492,48744,162800,228824,174760
53055,WA,"San Juan County, WA",8256,7593,663,8,8382,7959,423,5,8865,8516,349,3,17827,18615,18662,24,106,110,33,151,166,620,2372,4052,7413
53057,WA,"Skagit County, WA",63026,56908,6118,9,61280,57381,3899,6,61757,58498,3259,5,129884,130933,131179,334,1357,1380,326,1441,1562,8062,23151,33489,25972
53059,WA,"Skamania County, WA",5543,5038,505,9,5453,5104,349,6,5565,5271,294,5,12033,12207,12460,24,94,97,24,101,108,648,2891,3168,2341
53061,WA,"Snohomish County, WA",440728,402364,38364,8,437436,416470,20966,4,449837,435227,14610,3,829869,836037,840079,2408,9483,9643,1548,6262,6775,40876,133217,203192,195299
53063,WA,"Spokane County, WA",259796,237347,22449,8,259279,245137,14142,5,263187,250541,12646,4,541125,545498,549690,1514,5722,5850,1193,5446,6016,21314,84675,143971,115023
53065,WA,"Stevens County, WA",18789,17052,1737,9,18889,17607,1282,6,19223,17931,1292,6,46587,47553,48229,87,431,439,126,583,618,2530,11419,12272,6901
53067,WA,"Thurston County, WA",145539,133596,11943,8,144912,137276,7636,5,148608,141683,6925,4,295988,298078,298758,772,2999,3065,592,2720,2931,11932,44636,74343,74242
53069,WA,"Wahkiakum County, WA",1411,1289,122,8,1345,1254,91,6,1376,1283,93,6,4443,4579,4688,9,26,27,12,58,60,245,1008,1415,722
53071,WA,"Walla Walla County, WA",30351,28291,2060,6,30395,28914,1481,4,30723,29306,1417,4,62619,62158,61890,130,575,584,153,665,711,4750,8684,15852,11609
53073,WA,"Whatcom County, WA",115134,104424,10710,9,112503,105678,6825,6,115087,109454,5633,4,227430,226718,230677,522,1994,2035,459,1993,2147,10226,32806,52627,54708
53075,WA,"Whitman County, WA",22532,21254,1278,5,23425,22400,1025,4,23236,22150,1086,4,47804,43238,47619,103,373,380,59,345,392,1121,3695,7804,11486
53077,WA,"Yakima County, WA",132309,119710,12599,9,130342,121211,9131,7,131967,123515,8452,6,256702,256647,257001,931,3438,3509,678,2491,2694,40661,42114,44528,27655
54000,WV,West Virginia,779913,715637,64276,8,778747,739003,39744,5,785115,754453,30662,3,1791420,1785526,1775156,4296,17304,17484,5907,27437,29642,152581,512232,334820,278281
54001,WV,"Barbour County, WV",7168,6578,590,8,7188,6807,381,5,7379,7056,323,4,15463,15445,15414,45,156,157,58,262,284,1299,5661,2308,1388
54003,WV,"Berkeley County, WV",57863,54316,3547,6,59357,57192,2165,3,60015,58268,1747,2,122691,126194,129490,367,1520,1537,352,1449,1559,7944,30806,24594,19351
54005,WV,"Boone County, WV",7333,6574,759,10,7100,6663,437,6,7060,6740,320,4,21739,21367,20968,57,214,220,90,365,396,2501,7418,4018,1767
54007,WV,"Braxton County, WV",5176,4649,527,10,5059,4717,342,6,5029,4722,307,6,12397,12293,12185,16,101,101,44,183,200,1687,4449,1965,1300
54009,WV,"Brooke County, WV",9720,8862,858,8,9822,9223,599,6,9877,9428,449,4,22472,22109,21733,32,164,166,89,416,433,1155,6836,5024,3362
54011,WV,"Cabell County, WV",41262,38012,3250,7,40957,39023,1934,4,41507,40036,1471,3,94234,93494,92730,251,964,976,337,1449,1569,6799,20562,18074,17906
54013,WV,"Calhoun County, WV",2484,2088,396,15,2445,2191,254,10,2460,2258,202,8,6199,6165,6068,13,62,62,24,111,124,744,2571,1019,493
54015,WV,"Clay County, WV",3094,2710,384,12,2986,2752,234,7,2963,2786,177,6,8007,7895,7814,18,91,91,30,152,166,1119,2918,904,673
54017,WV,"Doddridge County, WV",3885,3650,235,6,3866,3706,160,4,3849,3731,118,3,7787,7739,7698,13,57,57,26,94,105,981,2730,1451,780
54019,WV,"Fayette County, WV",15954,14378,1576,9,15663,14676,987,6,15725,14991,734,4,40425,40083,39487,107,399,401,142,716,790,4610,12893,7179,4832
54021,WV,"Gilmer County, WV",2286,2056,230,10,2333,2173,160,6,2348,2226,122,5,7397,7389,7325,13,57,56,22,101,110,817,2435,877,1047
54023,WV,"Grant County, WV",5888,5511,377,6,5970,5701,269,4,5957,5737,220,3,10988,11009,10968,31,116,117,33,185,200,1294,4200,1690,925
54025,WV,"Greenbrier County, WV",15476,14245,1231,8,15724,15016,708,4,15484,14899,585,3,32895,32698,32435,72,311,317,138,580,622,3161,9877,6878,4664
54027,WV,"Hampshire County, WV",10603,10026,577,5,10930,10551,379,3,11233,10936,297,2,23097,23374,23468,47,226,227,60,333,346,2191,8004,4676,2141
54029,WV,"Hancock County, WV",12941,11663,1278,9,12941,12128,813,6,13031,12393,638,4,29037,28591,28172,45,218,218,99,564,596,2176,8667,6954,3849
54031,WV,"Hardy County, WV",5723,5315,408,7,5631,5350,281,5,5697,5467,230,4,14241,14155,14192,35,146,147,41,212,228,1652,4937,2515,1379
54033,WV,"Harrison County, WV",33564,30931,2633,7,33501,31912,1589,4,33748,32532,1216,3,65839,65436,64915,174,672,683,215,907,995,5459,18346,12320,10978
54035,WV,"Jackson County, WV",12452,11388,1064,8,11750,11068,682,5,11753,11245,508,4,27720,27761,27716,68,299,303,114,421,447,2133,8669,5784,3466
54037,WV,"Jefferson County, WV",29547,27807,1740,5,30207,29256,951,3,30814,30049,765,2,57783,58520,58979,161,598,604,138,645,698,3840,12335,11343,12449
54039,WV,"Kanawha County, WV",81938,74795,7143,8,80038,75807,4231,5,79669,76671,2998,3,180217,177993,175515,411,1696,1721,630,3178,3416,12802,48268,34590,36055
54041,WV,"Lewis County, WV",6177,5510,667,10,6118,5692,426,7,6367,6069,298,4,17016,16897,16767,42,170,169,60,281,306,1533,5799,2915,1957
54043,WV,"Lincoln County, WV",7078,6372,706,10,7004,6541,463,6,7062,6708,354,5,20363,20191,19901,56,192,192,81,336,359,2782,6754,3962,1134
54045,WV,"Logan County, WV",11023,9704,1319,12,11035,10310,725,6,11235,10755,480,4,32510,31917,31316,79,290,292,126,617,676,4656,10690,5665,2657
54047,WV,"McDowell County, WV",4392,3850,542,12,4191,3841,350,8,4105,3847,258,6,18921,18413,17850,38,164,164,97,374,402,3638,7257,2506,914
54049,WV,"Marion County, WV",24823,22688,2135,8,24851,23534,1317,5,25292,24195,1097,4,56230,56117,55952,151,562,568,154,772,839,3423,15571,10393,9288
54051,WV,"Marshall County, WV",13323,12011,1312,9,13213,12384,829,6,13063,12409,654,5,30497,30208,29752,74,284,286,94,479,524,1673,9950,6771,4419
54053,WV,"Mason County, WV",10204,9350,854,8,10312,9747,565,5,10450,10003,447,4,25398,25290,25000,60,266,267,90,417,460,2502,8263,5078,2738
54055,WV,"Mercer County, WV",20664,18761,1903,9,20482,19241,1241,6,20514,19598,916,4,59517,59215,58700,156,609,613,248,1086,1177,6185,16456,10863,8771
54057,WV,"Mineral County, WV",12023,11123,900,7,12117,11542,575,4,12526,12054,472,3,26890,26866,26855,54,250,251,96,426,451,1257,9096,5091,4024
54059,WV,"Mingo County, WV",6700,5751,949,14,6210,5659,551,8,6361,6005,356,5,23487,23094,22573,77,283,286,95,430,465,4118,7736,3598,1534
54061,WV,"Monongalia County, WV",53991,50605,3386,6,54912,52687,2225,4,55550,53656,1894,3,105905,106487,106869,230,946,959,175,851,933,4453,16430,14702,30790
54063,WV,"Monroe County, WV",5970,5551,419,7,6022,5795,227,3,6191,5982,209,3,12380,12383,12296,40,132,133,32,232,252,1060,4808,1925,1367
54065,WV,"Morgan County, WV",8206,7714,492,6,8395,8095,300,3,8551,8310,241,2,17087,17280,17430,37,139,141,49,263,276,1367,5662,3389,2520
54067,WV,"Nicholas County, WV",9247,8287,960,10,8979,8438,541,6,8974,8558,416,4,24554,24415,24335,56,217,218,90,378,403,2047,8847,4433,2904
54069,WV,"Ohio County, WV",20169,18493,1676,8,20107,19064,1043,5,19894,19102,792,4,42338,41878,41447,94,379,385,149,720,774,2097,9841,7982,9934
54071,WV,"Pendleton County, WV",3620,3443,177,4,3720,3606,114,3,3826,3728,98,2,6132,6078,6011,17,49,49,29,132,140,798,2421,702,777
54073,WV,"Pleasants County, WV",2667,2372,295,11,2672,2481,191,7,2673,2530,143,5,7652,7612,7586,16,70,70,28,108,118,602,2683,1614,664
54075,WV,"Pocahontas County, WV",3783,3438,345,9,3863,3667,196,5,4024,3865,159,4,7864,7890,7819,19,78,78,26,126,141,1069,2982,1212,851
54077,WV,"Preston County, WV",15172,14070,1102,7,15400,14685,715,4,15600,14973,627,4,34187,34270,34172,77,275,278,94,460,488,3313,12281,5658,4276
54079,WV,"Putnam County, WV",26732,24778,1954,7,26581,25440,1141,4,27011,26119,892,3,57432,57355,57015,119,508,514,154,727,787,3051,14775,11889,10807
54081,WV,"Raleigh County, WV",30004,27357,2647,8,29480,27907,1573,5,29605,28513,1092,3,74386,73801,72882,175,690,699,281,1292,1402,7203,21319,14365,10602
54083,WV,"Randolph County, WV",12137,11036,1101,9,11870,11199,671,5,11776,11226,550,4,27892,27891,27600,68,263,266,83,412,454,2369,10530,4136,3553
54085,WV,"Ritchie County, WV",4335,3977,358,8,4298,4057,241,5,4228,4052,176,4,8426,8388,8207,19,79,79,31,148,156,1177,3147,1407,612
54087,WV,"Roane County, WV",5068,4448,620,12,4946,4526,420,8,4969,4654,315,6,13986,13912,13834,28,137,137,49,215,229,2016,4671,2165,1368
54089,WV,"Summers County, WV",4321,3988,333,7,4459,4247,212,4,4632,4461,171,3,11939,11892,11762,24,104,105,51,231,244,1481,3901,2461,1632
54091,WV,"Taylor County, WV",7693,7132,561,7,7782,7416,366,4,7925,7622,303,3,16684,16483,16342,26,149,149,66,266,290,1415,5396,3534,1973
54093,WV,"Tucker County, WV",3293,3021,272,8,3400,3217,183,5,3517,3382,135,3,6753,6675,6568,12,49,49,27,132,146,661,2405,1213,1111
54095,WV,"Tyler County, WV",3001,2684,317,10,2924,2689,235,8,2909,2736,173,5,8296,8243,8183,16,90,91,18,102,113,610,2931,1722,948
54097,WV,"Upshur County, WV",9527,8628,899,9,9629,9031,598,6,9658,9193,465,4,23813,23820,23712,59,215,219,59,315,350,2149,8299,3284,2665
54099,WV,"Wayne County, WV",15509,14217,1292,8,15399,14593,806,5,15595,14976,619,4,38864,38533,37998,89,366,369,154,668,719,5169,10780,7474,4858
54101,WV,"Webster County, WV",3253,2950,303,9,3202,3004,198,6,3158,3014,144,4,8356,8286,8167,19,70,70,25,121,135,1295,2865,1174,759
54103,WV,"Wetzel County, WV",6473,5829,644,9,6525,6079,446,6,6462,6102,360,5,14392,14195,14025,35,137,138,53,251,268,1165,5081,2757,1529
54105,WV,"Wirt County, WV",2225,1987,238,10,2236,2065,171,7,2256,2124,132,5,5186,5059,5091,17,56,56,12,74,81,703,1548,1078,545
54107,WV,"Wood County, WV",35960,32828,3132,8,35974,34049,1925,5,36439,34947,1492,4,84142,83791,83340,190,788,799,256,1273,1377,5639,21147,20543,13170
54109,WV,"Wyoming County, WV",6803,6134,669,9,6980,6567,413,5,7125,6816,309,4,21317,20991,20527,51,181,184,93,399,423,3541,7328,2996,1825
55000,WI,Wisconsin,3094716,2897422,197294,6,3099768,2981070,118698,3,3082128,2992049,90079,2,5896271,5880101,5892539,15554,60007,61639,14163,61805,63397,285275,1209751,1264360,1268299
55001,WI,"Adams County, WI",8110,7325,785,9,7913,7422,491,6,7703,7333,370,4,20675,20795,21226,36,109,110,80,307,308,1997,6783,5189,2475
55003,WI,"Ashland County, WI",7673,7009,664,8,7620,7230,390,5,7450,7158,292,3,16018,16054,16039,39,146,151,41,206,207,685,4142,4080,2097
55005,WI,"Barron County, WI",24081,22602,1479,6,24121,23171,950,3,23673,22881,792,3,46714,46746,46843,128,439,450,122,574,594,3133,11797,11321,6808
55007,WI,"Bayfield County, WI",7543,6844,699,9,7513,7079,434,5,7338,6989,349,4,16233,16304,16608,21,94,96,41,199,204,563,3359,4264,4128
55009,WI,"Brown County, WI",141328,132694,8634,6,141096,136228,4868,3,141235,137547,3688,2,268921,268814,270036,741,2934,3019,552,2464,2514,13669,52402,56260,56999
55011,WI,"Buffalo County, WI",6397,5918,479,7,6311,6041,270,4,6157,5920,237,3,13319,13312,13391,30,120,120,32,131,137,820,3833,3154,1906
55013,WI,"Burnett County, WI",7244,6583,661,9,7331,6937,394,5,7158,6827,331,4,16579,16759,17036,29,105,107,43,205,207,922,4783,4178,2703
55015,WI,"Calumet County, WI",27303,26004,1299,4,27459,26675,784,2,27499,26859,640,2,52462,52587,52718,112,474,483,91,412,421,1876,11389,11848,10884
55017,WI,"Chippewa County, WI",33125,31038,2087,6,33581,32243,1338,4,33614,32504,1110,3,66337,66628,66807,171,645,663,147,672,697,3401,15730,16654,10924
55019,WI,"Clark County, WI",17564,16764,800,4,17730,17152,578,3,17517,17054,463,2,34667,34722,34691,147,547,560,72,394,387,3700,8521,6510,2794
55021,WI,"Columbia County, WI",31417,29537,1880,6,31673,30587,1086,3,31740,30907,833,2,58516,58404,58193,143,547,559,150,629,641,2499,13564,15678,9866
55023,WI,"Crawford County, WI",7431,6880,551,7,7418,7084,334,4,7037,6770,267,3,16084,16082,16007,35,163,167,54,209,211,900,4745,4009,2070
55025,WI,"Dane County, WI",323340,307583,15757,4,328495,319051,9444,2,329593,322472,7121,2,562577,561724,568203,1483,5620,5776,956,3919,4036,14439,64956,93427,195125
55027,WI,"Dodge County, WI",47709,45169,2540,5,47950,46410,1540,3,47390,46166,1224,2,89353,88657,88282,193,738,756,240,1196,1228,5175,26216,21084,12113
55029,WI,"Door County, WI",15069,14032,1037,6,15522,14841,681,4,15065,14593,472,3,30120,30406,30526,49,191,195,83,384,389,1040,6462,7638,7940
55031,WI,"Douglas County, WI",23372,21230,2142,9,22742,21719,1023,4,22662,21739,923,4,44343,44026,44144,90,372,382,112,539,558,1819,9191,12185,8397
55033,WI,"Dunn County, WI",23802,22469,1333,5,23891,23028,863,3,23915,23171,744,3,45441,44509,45651,99,400,408,73,365,369,1665,9044,8816,8283
55035,WI,"Eau Claire County, WI",58811,55491,3320,5,59655,57701,1954,3,59738,58235,1503,2,105874,105988,106837,292,1112,1145,211,1032,1029,2997,17634,24022,22253
55037,WI,"Florence County, WI",2202,2024,178,8,2220,2113,107,4,2141,2065,76,3,4560,4586,4688,9,28,28,13,79,82,298,1257,1295,741
55039,WI,"Fond du Lac County, WI",56178,52841,3337,5,56390,54540,1850,3,56322,54882,1440,2,104150,104166,103836,252,962,996,274,1132,1183,5647,26132,24162,16679
55041,WI,"Forest County, WI",3921,3423,498,12,3883,3624,259,6,3828,3648,180,4,9165,9262,9381,25,109,109,25,133,134,665,2605,2355,996
55043,WI,"Grant County, WI",27518,26067,1451,5,27240,26396,844,3,26960,26221,739,2,51984,51285,51276,166,541,548,136,574,595,2497,11023,11184,7741
55045,WI,"Green County, WI",20415,19411,1004,4,20721,20086,635,3,20769,20264,505,2,37036,37018,36816,93,335,346,101,422,429,1889,9081,8927,6450
55047,WI,"Green Lake County, WI",9294,8651,643,6,9320,8913,407,4,9132,8828,304,3,19022,19249,19220,45,174,179,61,257,264,1256,5175,4066,2885
55049,WI,"Iowa County, WI",13519,12683,836,6,13582,13116,466,3,13563,13211,352,2,23709,23777,23865,61,229,234,57,241,247,696,5775,5823,4438
55051,WI,"Iron County, WI",2569,2276,293,11,2559,2395,164,6,2507,2379,128,5,6146,6193,6224,14,41,41,26,108,109,208,1594,1938,1117
55053,WI,"Jackson County, WI",9985,9049,936,9,9526,9034,492,5,9350,8995,355,3,21096,20899,20836,46,211,212,71,264,276,1411,6286,4788,2390
55055,WI,"Jefferson County, WI",45455,42942,2513,5,45979,44415,1564,3,45889,44653,1236,2,86193,85796,85784,216,798,825,179,874,881,4457,18834,19663,16302
55057,WI,"Juneau County, WI",13411,12435,976,7,13420,12837,583,4,13265,12838,427,3,26780,26756,26866,52,214,219,69,301,306,1888,7957,6672,3025
55059,WI,"Kenosha County, WI",89716,83288,6428,7,89961,86034,3927,4,89931,86978,2953,3,169184,168465,167817,442,1721,1773,409,1706,1762,9879,32250,38637,33423
55061,WI,"Kewaunee County, WI",10705,10207,498,4,10770,10455,315,2,10795,10526,269,2,20550,20577,20623,57,194,195,54,230,231,888,5753,5173,2814
55063,WI,"La Crosse County, WI",65817,62224,3593,5,66483,64426,2057,3,66334,64691,1643,2,120930,119367,120294,302,1115,1152,262,1166,1199,3373,19758,27235,27334
55065,WI,"Lafayette County, WI",9886,9460,426,4,10131,9862,269,2,10083,9836,247,2,16613,16816,16877,58,244,251,36,161,170,960,4581,3606,2204
55067,WI,"Langlade County, WI",9368,8754,614,6,9405,8972,433,4,9231,8895,336,3,19462,19505,19559,40,179,182,66,281,294,1417,5855,4711,2276
55069,WI,"Lincoln County, WI",14820,13934,886,6,14773,14224,549,3,14710,14261,449,3,28429,28453,28376,60,248,254,71,432,432,1561,8768,6874,3969
55071,WI,"Manitowoc County, WI",40769,38218,2551,6,40906,39481,1425,3,40384,39256,1128,2,81384,81479,81172,186,729,755,204,1022,1026,4301,21097,20154,12834
55073,WI,"Marathon County, WI",72991,69316,3675,5,73348,71118,2230,3,72936,71105,1831,2,138047,137746,137958,362,1398,1450,277,1427,1444,6835,31571,31708,25470
55075,WI,"Marinette County, WI",19692,18142,1550,7,19411,18549,862,4,18913,18198,715,3,41885,41849,41988,98,369,374,156,630,636,2663,11975,10979,5509
55077,WI,"Marquette County, WI",7730,7206,524,6,7744,7395,349,4,7617,7348,269,3,15594,15777,15779,28,124,125,54,240,243,981,5065,3942,1592
55078,WI,"Menominee County, WI",1662,1402,260,15,1572,1439,133,8,1502,1419,83,5,4256,4292,4197,21,76,75,11,76,76,127,997,860,446
55079,WI,"Milwaukee County, WI",467309,428251,39058,8,464620,439453,25167,5,459063,442178,16885,3,938527,924207,918661,3054,12171,12515,2639,10107,10420,67517,178071,175637,201990
55081,WI,"Monroe County, WI",23554,22230,1324,5,23541,22763,778,3,23119,22503,616,2,46296,46246,46109,141,547,561,97,483,498,2881,11189,10578,6426
55083,WI,"Oconto County, WI",20595,19292,1303,6,20599,19817,782,3,20593,19952,641,3,39080,39393,39633,95,327,335,88,454,464,2228,11812,9572,4854
55085,WI,"Oneida County, WI",18020,16707,1313,7,18086,17299,787,4,17815,17226,589,3,37872,38282,38212,69,261,265,133,544,570,1529,9079,10378,7682
55087,WI,"Outagamie County, WI",103771,98000,5771,5,103913,100599,3314,3,104010,101397,2613,2,190961,191309,192127,542,2034,2093,374,1729,1792,7344,39515,42514,39588
55089,WI,"Ozaukee County, WI",48796,46125,2671,5,48938,47415,1523,3,48795,47593,1202,2,91613,92551,93009,202,814,837,214,940,958,1678,13252,16607,32097
55091,WI,"Pepin County, WI",4125,3881,244,5,4059,3919,140,3,4026,3900,126,3,7347,7386,7410,17,87,88,12,76,77,404,1928,1759,1198
55093,WI,"Pierce County, WI",24920,23163,1757,7,24272,23394,878,3,24410,23615,795,3,42223,41606,42532,89,339,347,57,348,355,1302,8272,9244,7833
55095,WI,"Polk County, WI",24681,22900,1781,7,24560,23505,1055,4,24379,23447,932,3,45032,45521,45709,102,395,402,108,484,495,2004,11732,11541,7246
55097,WI,"Portage County, WI",37802,35740,2062,5,37857,36501,1356,3,37544,36446,1098,2,70402,69429,70718,152,571,578,142,614,625,2377,14425,13526,15234
55099,WI,"Price County, WI",6266,5836,430,6,6266,5998,268,4,6192,5981,211,3,14032,14055,14179,24,92,93,43,206,209,804,4375,3743,1718
55101,WI,"Racine County, WI",98166,90950,7216,7,98417,93755,4662,4,98046,94599,3447,3,197536,196439,195846,513,2086,2149,552,2274,2349,11194,41240,46469,36193
55103,WI,"Richland County, WI",9096,8627,469,5,8954,8634,320,3,8830,8579,251,2,17272,17166,17090,43,156,157,64,218,227,1083,5011,3718,2468
55105,WI,"Rock County, WI",85658,79511,6147,7,85988,82108,3880,4,85560,82615,2945,3,163751,164192,164060,464,1871,1918,419,1848,1885,8897,38340,37422,27026
55107,WI,"Rusk County, WI",6599,6157,442,6,6536,6246,290,4,6454,6216,238,3,14179,14116,14186,35,127,128,45,193,198,1106,4258,3277,1707
55109,WI,"St. Croix County, WI",50672,47082,3590,7,49324,47579,1745,3,49555,48040,1515,3,93874,95055,96017,245,928,949,150,734,767,2318,15958,21293,23131
55111,WI,"Sauk County, WI",34623,31995,2628,7,34591,33177,1414,4,34199,33239,960,2,65793,65740,65777,180,689,706,163,740,760,3757,15128,15433,11368
55113,WI,"Sawyer County, WI",7997,7363,634,7,8042,7629,413,5,7913,7598,315,4,18123,18247,18559,35,135,137,62,260,267,875,4526,4500,3339
55115,WI,"Shawano County, WI",20900,19549,1351,6,20949,20154,795,3,20411,19816,595,2,40873,40812,40886,112,405,413,138,550,567,2197,12741,9468,4787
55117,WI,"Sheboygan County, WI",61852,58273,3579,5,61521,59570,1951,3,61269,59768,1501,2,118030,117697,117841,307,1135,1177,299,1306,1342,4960,27812,27601,21468
55119,WI,"Taylor County, WI",11055,10513,542,4,11073,10692,381,3,10556,10201,355,3,19937,19944,19975,64,218,223,40,202,209,1534,6060,3999,2295
55121,WI,"Trempealeau County, WI",15743,14631,1112,7,15400,14816,584,3,14842,14382,460,3,30806,30730,30899,121,409,419,70,318,323,1712,7833,6930,4222
55123,WI,"Vernon County, WI",15041,14249,792,5,15392,14886,506,3,15166,14758,408,2,30698,30921,31060,91,405,414,88,359,367,1971,7636,6141,4841
55125,WI,"Vilas County, WI",10381,9628,753,7,10466,9964,502,4,10148,9754,394,3,23097,23522,23763,41,136,138,83,319,341,870,5697,6177,5058
55127,WI,"Walworth County, WI",56854,53369,3485,6,57704,55578,2126,3,57511,55851,1660,2,105308,105200,105380,225,823,846,242,1196,1228,5927,21520,21923,21445
55129,WI,"Washburn County, WI",7849,7304,545,6,7906,7542,364,4,7675,7391,284,3,16613,16760,16911,28,106,109,56,253,250,894,4278,4426,2865
55131,WI,"Washington County, WI",76542,72189,4353,5,76442,74055,2387,3,76351,74489,1862,2,136784,137237,137688,273,1152,1187,308,1370,1419,4810,28273,31397,32051
55133,WI,"Waukesha County, WI",223362,210790,12572,5,223477,216435,7042,3,223209,217639,5570,2,407467,409080,410434,981,3702,3805,926,4187,4301,10328,59902,82105,134329
55135,WI,"Waupaca County, WI",25706,24271,1435,5,25835,24908,927,3,25151,24401,750,3,51791,51992,51488,138,462,467,194,798,813,2626,16189,11160,7615
55137,WI,"Waushara County, WI",11076,10363,713,6,11296,10813,483,4,11052,10675,377,3,24549,24797,24999,62,198,203,61,330,340,2048,7752,5712,3100
55139,WI,"Winnebago County, WI",92041,86979,5062,5,92137,89129,3008,3,92195,89846,2349,2,171800,170554,170718,445,1689,1740,390,1792,1821,7388,37563,36984,33927
55141,WI,"Wood County, WI",34731,32382,2349,6,34242,32711,1531,4,33450,32336,1114,3,74197,74085,73993,193,742,770,194,980,1004,3515,20444,18057,10798
56000,WY,Wyoming,293755,276495,17260,5,289154,275748,13406,4,291756,281343,10413,3,577605,579483,581381,1584,6157,6189,1300,6194,6679,24433,110950,143496,111283
56001,WY,"Albany County, WY",20563,19792,771,3,20651,19939,712,3,21252,20589,663,3,37110,37860,38031,87,317,320,53,260,274,879,3068,5363,11976
56003,WY,"Big Horn County, WY",5291,5024,267,5,5291,5047,244,4,5213,4998,215,4,11481,11645,11855,21,107,110,31,152,181,891,2171,3275,1567
56005,WY,"Campbell County, WY",23184,21572,1612,7,21955,20770,1185,5,22583,21780,803,3,47139,46533,47058,150,605,611,69,339,369,2287,10613,11131,6204
56007,WY,"Carbon County, WY",7922,7556,366,4,7765,7450,315,4,7413,7138,275,3,14504,14679,14542,38,147,149,31,174,177,1005,3795,3235,2022
56009,WY,"Converse County, WY",8004,7521,483,6,7501,7129,372,5,7652,7417,235,3,13741,13678,13786,44,143,145,29,149,162,629,3302,3411,2096
56011,WY,"Crook County, WY",3840,3690,150,3,3834,3700,134,3,3935,3818,117,3,7186,7319,7448,19,100,98,17,92,98,362,1477,1970,1221
56013,WY,"Fremont County, WY",19018,17818,1200,6,18839,17924,915,4,18896,18139,757,4,39197,39422,39472,105,454,455,123,559,596,2026,8100,9688,6506
56015,WY,"Goshen County, WY",6503,6219,284,4,6532,6296,236,3,6540,6348,192,2,12514,12557,12562,38,122,124,41,195,205,612,2578,3623,2106
56017,WY,"Hot Springs County, WY",2229,2117,112,5,2256,2166,90,4,2287,2220,67,2,4618,4574,4588,10,37,36,24,100,105,140,878,1507,830
56019,WY,"Johnson County, WY",4173,3941,232,5,4248,4067,181,4,4276,4128,148,3,8467,8633,8730,19,79,83,18,103,115,279,1504,2083,2175
56021,WY,"Laramie County, WY",50108,47523,2585,5,49121,47073,2048,4,48963,47233,1730,3,100718,100794,100723,286,1123,1129,232,1105,1194,4078,16923,26341,20475
56023,WY,"Lincoln County, WY",9291,8823,468,5,9443,9068,375,4,9608,9279,329,3,19657,20170,20660,62,230,232,53,173,188,839,4224,4891,2965
56025,WY,"Natrona County, WY",40118,36948,3170,7,38808,36416,2392,6,39179,37602,1577,4,80282,79660,79601,239,875,879,175,924,979,3255,15392,21973,13492
56027,WY,"Niobrara County, WY",1233,1187,46,3,1254,1208,46,3,1225,1190,35,2,2452,2414,2380,9,26,25,7,38,40,151,661,712,405
56029,WY,"Park County, WY",15198,14373,825,5,15463,14805,658,4,15510,14955,555,3,29664,30142,30518,59,286,289,72,375,424,991,5533,7797,7058
56031,WY,"Platte County, WY",4579,4347,232,5,4499,4311,188,4,4461,4306,155,3,8632,8674,8645,24,79,77,30,133,156,547,2426,2152,1476
56033,WY,"Sheridan County, WY",15997,15197,800,5,16003,15305,698,4,16180,15640,540,3,31005,31667,32096,75,305,307,77,350,380,910,6246,7762,6778
56035,WY,"Sublette County, WY",4020,3727,293,7,3960,3729,231,5,3918,3756,162,4,8738,8725,8763,29,91,93,18,73,81,303,1969,2206,1623
56037,WY,"Sweetwater County, WY",20510,18981,1529,7,19354,18243,1111,5,19507,18696,811,4,42190,41582,41345,113,454,453,95,424,436,2029,9069,11324,5394
56039,WY,"Teton County, WY",15138,14237,901,6,15906,15375,531,3,16647,16193,454,2,23377,23622,23287,62,220,216,17,93,105,701,2984,3755,10219
56041,WY,"Uinta County, WY",9105,8525,580,6,8812,8355,457,5,8863,8524,339,3,20457,20655,20712,58,227,226,43,185,199,851,4820,5186,2376
56043,WY,"Washakie County, WY",3944,3736,208,5,3939,3776,163,4,3858,3704,154,4,7658,7712,7719,19,73,75,32,110,115,320,1391,2293,1419
56045,WY,"Weston County, WY",3788,3642,146,3,3718,3595,123,3,3792,3691,101,2,6818,6766,6860,18,57,57,13,88,100,348,1826,1818,900
